I feel like the 2016 Presidential race is @realDonaldTrump vs. Matropolis ie The Machine.    Lets defeat the machine 	FAVOR
@moonlightnstars @RichardFLopes @edmontalbans you're right and I didn't vote for Obonzo and not voting for #Hillary 	NONE
NASCAR abandons Trump. Some good news to end my day with   #Trump 	AGAINST
just want to give a big #shoutout to my #1 man these days, @realDonaldTrump  Get 'er done, big guy!!  	FAVOR
hey y'all giving a big old s/o to donald trump, we settled our differences and are butt tight now 	FAVOR
Goodbye Macy's, nbc,univision. Illegals are raping&murdering thx to Obama. Trump is right. 	AGAINST
@inmatemd @ChuckNellis @Oh_MarieLoDuca We can only hope 	NONE
@POTUS The whole light thing with the people's house was disgraceful.  	NONE
Go back to focusing on brainless beauties... Oh wait you can't cuz you've been fired #NBC #youlose #sorrynotsorry 	AGAINST
I'm voting for Donald Trump ! 	AGAINST
Donald Trump gets the boot from #NBC for calling immigrants rapists and murderers. Hey Donnie, where's your wife from again? 	AGAINST
No you see Donald Trump was saying Mexican immigrants are all *rappists* like with the hip hop y'all  #Trump 	FAVOR
Donald Trump is only saying what ALL the other 2016 GOP Presidential candidates are thinking! Bad things!! #GOP #Trump #POTUS 	AGAINST
@Rene_gadeCowboy @danoroadblade yes but if a cop bust a bunch of people having a riot it is a hate crime 	NONE
@ChrisleyChase think your adorable. Remind me of my nephew. Stay young. The new comb over you're sporting is aging you. 	AGAINST
Greece.... Bernie Sanders school of economics #greta 	NONE
Is one cup of coffee ever enough?! #COFFEE 	NONE
@CNNPolitics @CNN if you spent as much time covering Bernie Sanders as you do Trump, Sanders would be ahead in every poll.   	AGAINST
@xmoraldk Glad we have each other on Twitter along with our home/community lives. You guys ROCK! #BeBlessed 	NONE
"@business  ""@HillaryClinton can't even manage @billclinton and she wants to be @POTUS"" #lol #OhHillNo #StopHillary2016 "	AGAINST
@realDonaldTrump Illegal Immigration is FINALLY on the agenda because of you! Thank you for speaking TRUTH! 	FAVOR
Terrorist takes selfie post on media,USA bombs target, USA tells world how they did it so they they never have 2 repeat it. 	AGAINST
#Trump is ruining a party quicker than the police! #gop 	AGAINST
@wpaulsen31 If a candidate seems to dumb to debate my paper boy hes not getting my vote 	NONE
Left-wing media trying to silence @realDonaldTrump? HAHAHA  Keep trying! Trump is NOT a career politician & he won't be bought!  	AGAINST
@mailandguardian There goes the Latino vote, Donald Dumb!! 	AGAINST
@haleyelenaa and his favourite beaches are probably in Acapulco and Cabo  	NONE
@DannoHollister @D2243 @BreitbartNews It might be time for WE THE PEOPLE to declare Independence From the Federal Government! 	AGAINST
Of course @TheJuanWilliams is completely wrong on the @SCOTUS ruling on #obamacare . @MichelleFields is right! 	NONE
Just so its not lost, today ISIS executed 74 children. To make it worse, our President was tweeting about basketball. 	AGAINST
@RSherman_25 Join Twitter Trump brigade #onethousandtweets to support message #MakeAmericaGreatAgain @realDonaldTrump 	FAVOR
Time for Texas & Oklahoma to think about a no fault divorce from the Divided States of America.   #TCOT #CCOT #tippingpoint 	NONE
@GalaxySojourn until their welfare is cut, their freebies taken away the #plantationparty will always vote dem 	NONE
@whitewolf2226 @mjgranger1 @BurdenoFreedom that's right I agree w/u girl 	NONE
Hey #UniteBlue look at #Greece - that's America's future thanks to you and Obama adding 8 Triion in U.S. debt. 	NONE
No wonder they don't listen to us.  It must get awfully loud inside the echo chamber.  @ESPN @NBC @Macys @NASCAR 	NONE
Without mexicans illegal or legal US shuts down,Your people will never be able to keep up with our hard workers. #WeAreMexico 	AGAINST
@Crypt1cality @ChrisCuomo Illegal aliens are destroying America and raping our women! 	AGAINST
@realDonaldTrump had a point and one the liberal media won't dare come close to! We have a fragile and wide open border!  	FAVOR
@realDonaldTrump I hope and pray you get the nomination. America needs a man with a backbone! And one that can't be bought! 	FAVOR
Honestly though @Macys you dumped Trump so now I'm dumping you. And I shop at your store A LOT. NOT ANYMORE BYE 	AGAINST
Looking at presidential candidates, there is only one candidate, who can stand tall, and is all heads and shoulders. #Trump  	FAVOR
@_George_Lopez__ says there may be enough AMERICAN Racists to Elect Trump as President. I think he's right. Take back America 	AGAINST
@CNNPolitics @Eugene_Scott  Careful Donald. Don't get carried away. 	AGAINST
I am not sure who is coming from other countries but I will assume they must be bad cause I am rich. 	NONE
@andersoncooper #AC360 @ac360 @ananavarro < WHY IS YOUR HISPANIC LATINO ASS SAYING @realDonaldTrump SAID DISGRACEFUL THINGS? 	FAVOR
@realDonaldTrump suing Univision & NBC because they cut you off. UGH great political move, because we need a greedy President! 	AGAINST
The moment you opened your mouth,  that was the end of your candidate trip! @realDonaldTrump 	AGAINST
hey @Macys a whole bunch of us are going to sever ties with you.   #Macys 	AGAINST
Cashinin A Block) Terror&4th July, terrorists win? B) Trump v NBC, Univision, Macy's C) Cuba D) WhiteHouseLights FNC 1130aET 	AGAINST
@lybr3 @MarcATL76 #Programmed ppl are so damn STUCK ON BS! Clinton is free walking behind a rope! BARS ARE NEEDED! PLZ! 	NONE
"@MichelleFields ""It's not SCOTUS' job to fix up Congress's mess!"" #Cashinin "	NONE
@realDonaldTrump @ReillyCarole So he can outsource all our manufacturing to Mexico and China like he does his line. #hypocrite 	AGAINST
Trump believes in traditional marriage so strongly that he's been traditionally married 3x. He should teach a class or something. 	AGAINST
@luzcarolinarov @damian_becker Right-wing idiots in the US are capable of anything. Including voting for extreme racist 	AGAINST
I really hate these stunts.  We already know how ignorant the post-Reagan generations are.   	NONE
@realDonaldTrump @Virginia4USA @ArtistdeeDd @HowardKurtz We all Mr. Trump. #usa  	AGAINST
It's time for @Senate_GOPs @HouseGOP to start doing their jobs for US CITIZENS and stop giving in to @barackobama 	AGAINST
"Yo DEMOCRATS, #NYSE Halted-Down. Just another ""CRISIS"". What ya gonna do to NOT LET IT GO TO WASTE???????????????  "	NONE
Donald Trump isn't afraid to roast everyone. 	FAVOR
@realDonaldTrump First sentence a must, but he'll NEVER be my President. #Truth will be revealed. He's an Indonesian citizen.  	AGAINST
#FELLOW TEXANS WHO SHOP FIRE @MACY'S AND SHOP #DILLARD'S! 	AGAINST
a clown who wants to be president #youcantdoit #MexicansAreChidos 	AGAINST
The California draught is a myth created by the government. The point was to conserve water for use in the war against ISIS. 	NONE
Trump, the best thing to happen to the Republican Party or should I say the Democratic Party. #keeptalking 	AGAINST
trump slogan : THEN IMPEACH ME #continuedontheback : start learning your own god damned government and THEN WHY DONT U RUN 	AGAINST
Really @CNN? You're asking aloud whether a Mexican who lives down to a stereotype, validates the stereotype? #immigration 	NONE
@exjon @bjcowan1970 AMERICAN companies won't make them anymore 	NONE
@rodrickgibbons @ByronYork @geoffcaldwell Maybe if we make it a Toll Bridge, we may recoup some of the welfare payments! LOL 	AGAINST
@realDonaldTrump Everyone is afraid to put a plan on the table for fear they'll be called a racist...America deserves better 	FAVOR
#PrezTrump had a great week, he's the BIG news story, mission accomplished. #tcot #TeaParty 	FAVOR
Donald Trump is so crazy I'm scared if I was hanging with him he would think it would be okay to sell me back to slavery! 	AGAINST
So, Donald gets fired, but reverend Al is still employed. Both are idiots. Makes zero sense, #NBC 	AGAINST
We are now witnessing possibly the most disastrous attempt to run for presidency ever, courtesy of @realDonaldTrump #Fail 	AGAINST
@realDonaldTrump keep it up Mr Trump-when the Dems and Repubs are attacking-you know your doing it right! #MakeAmericaGreatAgain 	FAVOR
.@realDonaldTrump is the real deal folks. He tells the truth. Get used to it! 	FAVOR
@realDonaldTrump @ericbolling GOP wants to discredit Mr. Trump and his reputation clean like diamonds #usa 	FAVOR
My Message To LGBT Rights Supporters: If You Hate America, Please Leave. 	NONE
@realDonaldTrump let the haters run away. You can now see who  you're true supporters are. 	AGAINST
@realDonaldTrump Any more campaign stops in Chicago anytime soon? Good luck! 	FAVOR
@JebBush and @marcorubio cannot speak their minds b/c they are paid 2 keep things pc. @realDonaldTrump ANSWERS TO NO ONE! 	FAVOR
@CindyReynolds I have to turn the channel, all I can do is stare at that nest on his head. 	AGAINST
@EWDolan #DoubleBlindJepordy What is you keep my wife out of the GOP Primary and I'll keep your wives out of it too!  #Bam! 	NONE
@BraveConWarrior stories like this make think PATRIOTS are at the end of the string. all kinds of shit is going to hit fan 	AGAINST
@realDonaldTrump your directness & honesty has moved you to the top of my list 4 #President2016! #TRUMPTRUTH 	FAVOR
Just because you own a casino (bankrupt) doesn't mean your family didn't immigrate too #America 	AGAINST
@meetthepress @ron_fournier @realDonaldTrump Typical Liberal Media. Trump has now evolved. He is now non Mexican Pro Life. 	AGAINST
what is it with the pple who enjoy harassing me by writing captions on my photographs @Lrihendry? #scientology    #hurtful 	NONE
What are your favorite conservative blog sites and why?  #tcot #RedNationRising #CulturalRot 	NONE
@NBCNews @realDonaldTrump or the white house!! #trumpforpresident 	FAVOR
#NothingMoreAmericanThan complaining about Mexicans when you've been marketing off their labor. 	AGAINST
Tuesday AM #TrumpDump on horizon. I can see Chris Christie being victim. NBC for sure. Anyone else? #TellingItLikeItIs 	AGAINST
Unlike Obama, @realDonaldTrump doesn't need a teleprompter.  	FAVOR
delusional - adjective  1. having false or unrealistic beliefs or opinions 2. Donald Trump  #presidentialelection2016 	AGAINST
@soxsher @Lrihendry @realDonaldTrump  Please make it right again! 	FAVOR
@realDonaldTrump keep it up Trump we love you #MakeAmericaGreatAgain #BoycottMacys #boycottnbc 	FAVOR
Please, understand that Donald Trump mouth is full of shit due to his Mexican maid having access to his toothbrush. 	AGAINST
Thinking about deactivating my personal facebook account 'cause it's too liberal for me. Liberalism is a mental disorder. 	NONE
Who among us has never defamed an entire country on nat'l television while declaring candidacy for president? #perspective 	AGAINST
"@NBC to #Trump: ""HOW DARE YOU POINT OUT THAT OBAMA CAUSES 1000 GIRLS TO BE RAPED EVERY MONTH CROSSING INTO USA!""  #ccot #tcot "	AGAINST
Important part of platform.  Make it illegal to talk during #TrueDetective  #GOP #Election2016 	AGAINST
@realDonaldTrump Now that you're the leader of the GOP, will you show them what Leadership is? #MakeAmericaGreatAgain 	FAVOR
The whole Latino community will not be voting for 	NONE
@NBCNews political correctness is killing the country! The Don is telling the truth! 	FAVOR
@nytpolitics and will stop Illegals from killing our citizens. 	AGAINST
@realDonaldTrump is the only candidate who has the backbone to get our #country back on the #rightpath 	FAVOR
"If a liberal brings up Immigration, hit em with the ""TRUMP"" card! #trumpforpresident #Trump #tcot "	FAVOR
@Reince @SharonDay @realDonaldTrump @tedcruz @JebBush Wshgton Cartel, incompetent GOP leaders support losers like Romney, McCain! 	AGAINST
he was getting divorced & filing bankruptcies @robin182zz #Trump #bankrupt #Election2016 	AGAINST
RNC Chairman pleads with Trump to tone it down. I say, Ramp-it-up 	FAVOR
Liberals do not like that @realDonaldTrump is moving up in the polls. #MakeAmericaGreatAgain #TheGreatWallofMexico 	FAVOR
@realDonaldTrump they may be dumping you now, but when you're president they'll be begging for your business. 	FAVOR
@JeffYoung @ThePatriot143 I fully support full repeal. I will work for candidates who I believe will make it happen! 	NONE
@MoveOn Go screw yourselves & take Killary with you! Bring your bully shit to Florida and see what happens! #boycottMoveOn  	NONE
What happens first? Yellowstone blows or GOP prez candidate calls Trump racist? 	AGAINST
@realDonaldTrump  I like Mexicans who come to US legally.  #IStandWithTrump 	FAVOR
@BillKristol GOP, Dems & Media are all scared of Trump. I am thoroughly enjoying the hand-wringing and hysterical name calling. 	FAVOR
@realDonaldTrump is the most repulsive narcissist on the planet. 	AGAINST
@BillGates Can you reset my Windows 98 password?? 	NONE
Lying to justify political correctness is still nothing but a lie.   #Teaparty 	AGAINST
Political policies are reversible, genetics are not. That's why we must defend our borders from the third world.   	AGAINST
@inspirationguy U r a LOSER and jealous of me cos I'm RICH #TrumpWillBeThePrezCosWinningIsAllHeDoesUnlikeYouLosersAlsoBanTheTacos 	AGAINST
I wonder if Trump's campaign manager is still just drinking or have they moved on to harder stuff. 	AGAINST
@realDonaldTrump Let's face it, we've become a passive, inert nation controlled by thugs, and redistributionists. 	FAVOR
A vote against Trump is a vote against America 	FAVOR
@PoliticalLaughs Meanwhile, derelicts, deviants, and bedlam thrive under Obama. 	AGAINST
Normalize relations with ISIS for our economy, @ericbolling would you do it? there is a line what we should do for money. 	AGAINST
@realDonaldTrump Don't let the @GOP tell you how to run!  #America doesn't need another politician.  #MakeAmericaGreatAgain only 	FAVOR
If my only impression of the US was Donald Trump, I think I would hate it. 	AGAINST
@GoAngelo it's obvious Macy's and NBC and ESPN and ... are chokers. #Trumpisassclown 	AGAINST
"@KidDynamiteBlog Between #Hillary2016 ""a sadistic psychiatric nurse let loose in a lunatic asylum"" & #bush16 ppl may vote #Shit! "	NONE
Finally a highly intelligent, economically competent contender for The President. TRUMP #Trump #realdonaldtrump 	AGAINST
@seanhannity @BobbyJindal He would be great Vp for Trump.. 2 of  kind,#MakeAmericaGreatAgain , 	AGAINST
@realDonaldTrump Go get 'em Mr. Trump!!! 	FAVOR
I like many entries in the 2016 Presidential race; but no one is more accomplished than Donald Trump. His cabinet will be full. 	FAVOR
@alexisgoldstein @alexfrangos #BusinessMatters @BBCWorldBiz @bbcworldservice midnight gmt #Grexit #Obamacare #ironmaiden 	NONE
Donald Trump for president? I can dig it.  	FAVOR
@CNNPolitics @jaketapper @GovernorPerry @SaraMurray Not enough. 	NONE
571 Days Left Until Obama Leaves The White House. 	NONE
@BlissTabitha No, stand up for America, fiscal responsibility, strong defense, less transfer of wealth, less government. 	NONE
@peddoc63 @realDonaldTrump So I guess Univision is Fair & Balanced. These are the people that R helping shape USA! 	AGAINST
What's @realDonaldTrump wife's Twitter handle? I need to ask her if his balls are made of brass...I'm certain they are.   #NoHomo 	AGAINST
Honestly I am gonna watch #Univision so much more now, just to support the network against 	NONE
I don't even recognize America anymore. #scary 	NONE
@realDonaldTrump Just watched you on @FoxNews. You are awesome! You have my vote! #MakeAmericaGreatAgain 	FAVOR
@Radiocop @DrLefever Low Info Voters are still clueless to the fundamental transformation Obama said he would inflict. #tcot 	NONE
@kupajo33 @ChrisChristie we don't need him! 	AGAINST
@BretBaier #CandidateCasino #Trumps the real deal, hand him the wheel, he can drive &make the climb to take #US up the hill. Vote 	FAVOR
Donald Trump stays roasting on Twitter  	AGAINST
ENOUGH. 4FAR 2LONG  2% of pop. has dictated 2the 98% due 2fear by PCpolice/afraid 2b called a bigot/racist. NO MORE!  #ccot 	AGAINST
@ZekeJMiller @Reince @SharonDay GOP plan to stop Trump? LOL Maybe they can put up loser candidates like Romney, McCain and Jeb! 	FAVOR
@TMZ trump a guy born with a silver spoon up his ass who has never done a hard days work in his life  #DumpTrump #YoureFired  	AGAINST
Liberals are winning the battle of the mind by indoctrinating low IQ & youth of #America through #MSM & social media 	NONE
Why is it wrong when Trump is stating facts about illegal immigrants??? He is 100% Right 	FAVOR
Hey @MayorGregor thanks for letting a racist bigot build a giant tower with his name on it downtown. Real proud of ya. 	AGAINST
@Colin_McManus7 2016 is the first election I can vote in and I am proudly voting for @realDonaldTrump #trumpforpresident 	FAVOR
More people should pay attention to the Greek situation cuz it's the first dominoe to fall #Grexit #tcot 	NONE
@UPROXX good,, trumps speaking of illrgal immigrants,,, its her loss 	AGAINST
@NachoQuesado @kevinsnebula @iconogasmic @Anarkitteh @alaindebotton Your Fired! #yourfired #UpWithTrump 	FAVOR
I would be so embarrassed if @realDonaldTrump were my dad. My dad was #conservative #Marine but not stupid or unkind. #yuck 	AGAINST
White terrorism is alive and well 	NONE
@realDonaldTrump  WE WANT TRUMP! WE WANT TRUMP! WE WANT TRUMP!!! #MakeAmericaGreatAgain 	FAVOR
If the Obama cabinet was on the apprentice who would you fire?  Kerry was the answer. #talkcityclub 	NONE
Obama is Liberalism's false idol. Reject that P.O.S. #VoteOutRino's #BoycottMSNBC #VoteCruz #MichelleObamaIsAMan 	NONE
Why are free market conservatives behind a multiple bankruptcy candidate who wears makeup. Gives us real conservatives a bad name 	AGAINST
@USAlivestrong @scottscameron @ljmljm55 @blondygirl1 @eavesdropann @autumkat @texasflutegal 100% Support #Trump.. 	FAVOR
@mdsbarry ILLEGAL ALIENS come to US collect welfare and social security, its time to #MakeAmericaGreatAgain SECURE OUR BORDERS  	AGAINST
Trump is a Non-Establishment candidate.  I like it!  #MakeAmericaGreatAgain 	FAVOR
@FNC_Ladies_Rule @MichelleFields @JonathanHoenig @JessicaTarlov Can't wait to get home and see the episode.  	AGAINST
These noodles on my head are so hard to comb! 	AGAINST
@msnbc @chefjoseandres good riddance to bad rubbish, 	NONE
With his immigration policies pwr drunk #Obama is setting himself up 2 b prez of Mex when he gets evicted from WH  #tcot 	NONE
The Leftist Liberals are starting an internal war within America. 	NONE
@Macys not selling Trump because he voices his opinion.. What happy to freedom of speech.. I'll never shop at @Macys again.. 	AGAINST
@thehill you continue to shoot yourself in the foot. I guess this is for entertainment purposes only! 	NONE
Unfounded data/support for such drastic claims to be made against Mexico & all its ppl sorry guys I guess I rape & sell drugs 	AGAINST
GRATE TWO SEE @realDonaldTrump GET TUFF ON BOARDER CONTROL!  HAS MY VOTE IN 2016!  #TCOT #ILLEGALSSTOLEJOBS 	FAVOR
@ericbolling let @MichelleFields loose on @TheJuanWilliams when he makes idiotic unsubstantiated statements. #CashinIn 	NONE
I just cancelled my reservation at the Trump hotel in Las Vegas.  I hope like minded people intolerant of bigots do the same 	AGAINST
Did anyone cut ties with Senator Lindsey Graham when he called all Iranians liars? NO.  	AGAINST
Everything Donald Trump said was 100% true though. 	FAVOR
@WashTimes @billpostmus #CONGRESS approve this already! Let President veto, then overturn his veto. 	AGAINST
If Donald Trump is elected president I'm moving to Nunavut to get away from these retards #Trump 	AGAINST
@realDonaldTrump You go get em Donald!  The real folks are with you 110% 	AGAINST
@TPM Forget #AnnCoulter. Faux's #Hannity & #KellyFile have an endless supply of ignorant #GOP summer interns. #RWNJ #tcot 	AGAINST
@realDonaldTrump you're not playing to win this = 	AGAINST
@Reince & GOP You built that  -----> 	NONE
RT @_CFJ_: RT @bcwilliams92 Let's get this CLEAR! I DID NOT I REPEAT DID NOT vote on TPP  ~ Ted Cruz #CruzCrew... 	NONE
"@realDonaldTrump comments about Mexicans where he said ""somebody's doing the raping""  Why do bigoted WM claim to be crime free? "	AGAINST
The whitehouse displaying rainbow colors...are you shitting me? 	NONE
Maybe if more patriots raised a fuss and did what the gays and other minority groups do we'd get this country back 	AGAINST
@realDonaldTrump You have a real shot at POTUS Mr. T, the debates will be the true litmus test. 	FAVOR
@Greta trump a joke? Ur guest is a fool. Better a joke than traitor RINOs. It's trump or no one for me. Reps betrayed us. 	FAVOR
@POTUS what are your thoughts on 	NONE
@ericbolling @FoxNews I'll be there!! Who's on the panel? 	NONE
Corporate America showing there Asses, over #trump is just wrong! I am making note! 	AGAINST
@marcorubio .  Adios for your comments about @realDonaldTrump .. You are a disappointment. 	AGAINST
@realDonaldTrump You're FIRED! Now get out of here! Go!    	AGAINST
@RealJamesWoods @LoriBlaney My parents warned me to stay away from anyone offering free candy. NOTHING is ever free.  	NONE
Apparently #Trump values riches so much he can't afford values. #Trumpelstiltskin 	AGAINST
@realDonaldTrump we need you in office.. Keep doing what your doing. #VoteTrump #MakeAmericaGreatAgain 	FAVOR
They only did they gay marriage thing to get our attention off of all the shootings lately...  	NONE
Trump's comments show he cannot be taken seriously. The fact he's polling high shows the party should not be taken seriously. 	AGAINST
@ouchinagirl @TrumpNY2016 @GOP TRUMP FOR PRESIDENT AS HE DOESN'T MINCE WORDS!!!! 	FAVOR
Donald Trump:  proof positive that Gigantism is the last stage before extinction. #MissUSA 	AGAINST
@realDonaldTrump did not apply to immigrants one of the trade basis, WIN TO WIN. Ignorance can not be excuse 	AGAINST
@marcorubio @GovernorPerry @GrahamBlog @McConnellPress Your silence is deafening. #TrumpIsRight #SecureTheBorder #illegalaliens 	FAVOR
@gbennettpost @jamiedupree No  #asstards!  America is dumping you! Trump's gonna put your dicks in the dirt! 	AGAINST
.@nbc ends relationship with @realDonaldTrump over his disgusting derogatory remarks. This man ha no place in the White House. 	AGAINST
People: Donald Trump is a man who can lead this country into the future. 	FAVOR
@lemurdue77 Hey friend. That's not nice  	NONE
Hey hypocrites @Macys since u pull @realDonaldTrump merchandise from stores why dont u pull #racist #JAYZ CRAP #2FACEDLIBERALS 	AGAINST
@blackrepublican only if we stop allowing them 2 work & stop welfare they will self-deport #tcot 	AGAINST
There is no scarcity. There is no lack. No need for poverty. We are only victims of robbery by our leaders. #LiberateYourself 	NONE
And how many  #latinos enemies you gained in 1 week? 50 million!! @realDonaldTrump 	AGAINST
I hate it when percent try to out-bitter each other. #UniteBlue 	AGAINST
Another Reagan the last thing we need! The #FatherofAmnesty rewarded 3m criminals, displaced 1.9m in workforce! @DaGodfather907 	AGAINST
Hey at @realDonaldTrump I'll vote for you if you adopt me! 	AGAINST
@GOP it's time you recognize @realDonaldTrump . This movement is real. #MakeAmericaGreatAgain 	FAVOR
So #Memphis will dig up #NathanBedfordForrest but #BillCosby keeps his star on the Hollywood Walk of Fame? #LiberalLogic 	NONE
And ask for handouts @jjauthor: When your family is short of money, do you take Lib option to increase spending? #racism 	NONE
Is it to early to start wearing shirts and sporting a bumper sticker? 	NONE
@divadoll123 @LANURSE1 @ShaninZT u can't go back.Only way people r going to wake up is when the free checks stop coming!#TCOT 	AGAINST
"of the many @realDonaldTrump racist comments, this one takes the prize!  ""Laziness is a trait in blacks.""  "	AGAINST
"You can ""try"" to take my #ConfederateFlag down & you will successfully fail to do so. "	NONE
@realDonaldTrump what NBC actually stands for....Nothing But Crap. #BoycottNBC 	FAVOR
Black lives only matter to politicians around election time. 	NONE
@MarioLopezExtra @nbc fires Trump, but maintains strong ties with @BWilliams @TheRevAl #LAUGHABLE #JOKE #LIARS #NBC GO 	FAVOR
Get the truth from Trump! @realDonaldTrump 	FAVOR
Will be watching @AC360 again tomorrow to watch @realDonaldTrump interview continuation. #MakeAmericaGreatAgain 	FAVOR
@WhipHoyer @CorlessJones haha ACA is far from affordable you bunch of GRUBER idiots! 	NONE
So I'm guessing there won't be a #SlovenianFirstLady in #TheWhiteHouse!  	AGAINST
@toddstarnes the plan is on paper & in pencil. Degrade = erase 1 letter at time destroy = throwing the paper away! 	NONE
@realDonaldTrump You are absolutely right on the border! Bush and company are afraid to address it! #MakeAmericaGreatAgain 	AGAINST
It's funny when politics seem like farce. Not so funny when politics becomes farce. 	AGAINST
Mr. @realDonaldTrump   I appreciate you standing your ground as you've done.  I can say I've never felt better about voting. 	FAVOR
Just watched @realDonaldTrump speech. How embarrassing for his family! Like that's a really bad dad moment  	AGAINST
There is a fine line between right and damnation  and in my opinion the US is going down the wrong damn road #votethemallout 	NONE
Trump for prez he couldn't do any worse so give him a shot 	FAVOR
White, male, hetero, homeschooler, Christian, gun-owner, conservative, pro-life, citizen. Things that make a man un-american 	NONE
Spine, I would like for you to meet the Republican Party.  	AGAINST
@realDonaldTrump: We have got to take our country back. It's time! Win it Mr. Trump 	FAVOR
@EmmittSmith22 Who cares about you judging? You run wiith an inflated animal skin for entertainment. More time for brain surgury? 	NONE
"Why does O refer to Iran, Hamas, Ebola, and ISIS in dramatically less critical terms than he does Republicans?"" #tcot "	NONE
I know this is super dorky, but I REALLY hope I get my acct back in time for #CashinIn tom.   @ProfessorF @JonathanHoenig   	NONE
nothing about obamacare changed today what changed is the total exposure of anti-constitutional terrorism at the supremecourt 	NONE
@QuiltingMuriel But I do agree about the excess speechifying and posturing and general nonsense. Hello 	AGAINST
Been slacking on my @realDonaldTrump retweets.. had some catching up to do .. #Trumpforpresident 	FAVOR
You can change the laws of America, but you can never change the Law of God. Marriage is between a man and a woman. 	NONE
@realDonaldTrump  Just registered to Vote Today so I can contribute to help #MakeAmericaGreatAgain #Honesty 	FAVOR
Will FOX News pick up #MissUSA and #MissUniverse?  Stay tuned to find out.  #YoureFired #NBC #FoxNews 	NONE
25% of Mexico has INVADED AMERICA - & CONTINUES to OCCUPY us  yet POS #RINO phony #Jeb BLAMES #TRUMP for telling the TRUTH! - 	FAVOR
Be prepared - if we continue the policies of the liberal left, we will be #Greece - 	NONE
The way @realDonaldTrump is taking flak, he must be over the target. 	AGAINST
RT @bdckool: .@realDonaldTrump Of you can do for America what you did for your businesses, you will secure my vote. 	FAVOR
@JudgeMbro Thank you for RT and FAV, judge!!! #USA #OhHillNo #Cuba #TodosMarchamos #Venezuela 	AGAINST
"Wow Quote ""try getting it out, you don't even know what you're talking about but go ahead, try getting it out "" smh #msnbc "	NONE
@DeeHoer420 That's right. CNN = LOSER. Anyone who has met Trump knows he is a down to earth compassionate gentlemanman.  	AGAINST
.@robertthedeuce True, @Obama @MSNBCYourBiz @AlanColmes doesn't care, It's NOT their money. Wait-up Greece, We're coming. 	NONE
Trump got the smarts to win the hearts 	AGAINST
@realDonaldTrump @LadyPatriot777 @Macys lousy merchandise made in China !!!!!!!  	AGAINST
@backatone000 @fatima_madsen This is a tragic outrage 	NONE
Well, someone's doing the raping. I get combed and gooped up so much, Donald's the one doing the raping. He never understands. 	AGAINST
Who doesn't love @SheriffClarke! A man who doesn't mince words!He's not going to sugarcoat it for you folks! #alllifematters 	NONE
@AnnCoulter @realDonaldTrump The Media will try to discredit him. Democrats and GOP will attack him. America will Stand with him. 	FAVOR
Donald Trump is the man of all men 	FAVOR
Donald Trump please shut the eff up forever! To think I liked your men's suits at Macy's! You suck! #andersoncooper #CNN 	AGAINST
@andersoncooper #AC360 @ac360 @ananavarro <WHY ARE YOU LATINO-HISPANIC DEFENDING #LATINO #HISPANIC RAPISTS? @realDonaldTrump 	NONE
@KarenMonsour12 Thanks Karen, love this idea! 	NONE
I wonder if Trump is at the Mexico soccer game in Chicago? I hear he has a lot of supporters there 	AGAINST
@realDonaldTrump Sir, i just want you to know that you'll be the greatest President of this Generation!  	FAVOR
@realDonaldTrump is such an idiot. He's risking way to much for something he'll never get. 	AGAINST
"John O'Donnell, former president of Trump Plaza Hotel & Casino ... @realDonaldTrump said ""laziness is a trait in blacks. "	AGAINST
If You Disagree With Montel, You Are A Racist. 	NONE
@avocadofact only 2% of illegals work farm jobs 	AGAINST
@JonathanHoenig @realDonaldTrump @feldmaniac @Mediaite Support Americas future Boycott capitalist pig 	AGAINST
@cvpayne @FoxBusiness yup you got that right 	NONE
".@Ashlandgirl101 @Braveheart_USA Don't just say ""no"" to Killary - work tirelessly to put her in prison - where she belongs. "	NONE
@protectedspeech It's pretty obvious who the real racists are.  	AGAINST
Americans of all pol parties are trusting you @realDonaldTrump - we KNOW you will put #AmericaFirst and #MakeAmericaGreatAgain 	FAVOR
America: Isn't it time we ignored Donald Trump? He's not a serious person. @NYPD should revoke his gun permit. #Immigration #NBC 	AGAINST
Dick Bove joins @ericbolling now to discuss the Greece financial crisis. #Hannity 	NONE
@2AFight All these shootings in America are planned. Stay safe stay second amendment. Illegal guns kill people way more wtf?!!! 	NONE
Liberalism is the politics of personal destruction! If Liberals can't win- they will lie & demonize! They are paid to attack! 	AGAINST
@realDonaldTrump is the ONLY candidate with BALLS!!!!! 	FAVOR
@SuzieQt154320: Just Curious Do You Follow @HahnAmerica Or @Montel_Williams? 	NONE
" TY Michael @ASavageNation ""I'd do anything to help him; he's right, he's telling the truth"" @realDonaldTrump #BoycottMacys  "	FAVOR
The more I read how NBC and Macy's are cutting ties with @realDonaldTrump the more I'm convinced he should be president.  	AGAINST
@realDonaldTrump No more Bush or Hillary Clinton 	FAVOR
Donald Trump....you're fired, fired, & fired again! 	AGAINST
#greta Trump is absolutely on fire right now! He is a good man with a great family. He is the medicine this country needs! 	FAVOR
It disgusts me how the White House can easily pass same sex marriage, but not marijuana at the same time. #WakeAndBake  	NONE
Witnessing the destruction of the #middleclass If you are black, white Hispanic, or any other creed support #Trump #usa #4thjuly 	AGAINST
RT @AhmedtheBanker: Let's not forget @realDonaldTrump lost money running a casino. 	AGAINST
Clearly @realDonaldTrump has very good finance people because his shocking racist comments proves he not an intelligent human! 	AGAINST
@gerfingerpoken Please RT the #ImpeachObama art at the top of this thread, pinned on my page. 	AGAINST
BretBaier ShannonBream remind Obama that the 2nd Amendment is here to stay as well! #TCOT #MOLONLABE #2A 	NONE
That Time Trump Spent Nearly $100000 On An Ad Criticizin US Foreign Policy In 1987 #america #DonaldJTrump #foreignpolicy 	AGAINST
@realDonaldTrump gonna be on @greta show right now! #greta #TrumpIsRight 	FAVOR
Greece is our future.  Pay attention.  #GreekCrisis 	NONE
Healthcare in America must be fixed. Women are everything.  #TeamJason  	NONE
5. Obama could kill us all with these race wars and black lives matters stuff. Divide and Conquer. #tcot 	NONE
And this dude wants to be potus #FOH 	AGAINST
So gays can get married, but I still can't legally own a pet monkey in the USA -.- #thisiswhatswrongwiththeworld 	NONE
Mainstream media should not be giving Donald Trump airtime. Focus on real issues. 	AGAINST
. @realDonaldTrump American was great until you embarrassed us all to death 	AGAINST
Get over to #CNN #AC360 @realDonaldTrump going live in minutes.  	NONE
i want donald trump to win the presidency so bad. he cant be bought out like all the others. and he sticks to his convictions 	FAVOR
"OBAMA LISTENING TO RAP ""MUSIC"" IN THE WHITE HOUSE IS A DISGRACE. YOU CAN'T SPELL CRAP WITHOUT RAP. #tcot #NoBama "	AGAINST
@realDonaldTrump I'm RTing every tweet you post! Go get em Mr. Trump- you're reigniting the fire of the American Spirit- FIGHT! 	FAVOR
Donald Trump is gonna end up like Hitler 	AGAINST
The media gathered the public like sheep over the rebel flag debate the government passed the fast track authority google it 	NONE
This country doesnt have victories any more.  When is the last time we beat china in trade? #talkcityclub 	NONE
@realDonaldTrump is the only candidate who has in no way, shape or form been brainwashed by the pc police. 	FAVOR
@Hohn_Jollis better than high-quality h2o farts 	AGAINST
@JonathanHoenig Why arent Americans allowed WEEKLY to vote on Bills that are passed by the elite on behalf of the masses? 	NONE
Conflict is a vehicle for change!  Ask @realDonaldTrump Trump becoming a front runner. #USA #leadership 	FAVOR
People who judge Trump based on his looks and hair style yet call him a racist bigot might be #hypocrites 	FAVOR
The line between innovation and effrontery becomes evident through consequence. #CultureShift #awaken #rise #AriseChurch 	NONE
Translation: I do not understand why the Republicans don't dismiss him. #Republicans 	AGAINST
Donald Trump inhaled so much air spray & started to believe he is the title holder for the United States. 	AGAINST
@thereaIbanksy stop making racist peopld rich! 	NONE
@realDonaldTrump You are the trump card of my heart. 	FAVOR
I'm offended @HillaryClinton is Not in Prison & I'm offended  hasn't started 2 #ImpeachObama Now @BarackObama  	NONE
Great interview with @BobbyJindal tonight! I can vote for this guy! #Hannity #lnyhbt 	AGAINST
@hamltonb026 that's the last thing I'm doing. I'm suggesting that liberals are the reason it is the issue it is today 	AGAINST
THE @realDonaldTrump **MAKING TWO FEES INSTEAD OF ONE**  WE NEED A WINNER IN THE WHITE HOUSE AGAIN  #MakeAmericaGreatAgain !!  	FAVOR
@realDonaldTrump I know I'm not the only person who can't wait to see your name on the presidential ballot and vote for you! 	AGAINST
@PatDollard She is right on the money!!!!!  	NONE
Why is the media giving the Donald so much airtime?The guy evades questions just like any other politician.Disaster. GOP trouble 	AGAINST
@realDonaldTrump is just saying what most are thinking, you have to give him credit #Trump4POTUS 	FAVOR
Trump Tower is not on fire. It is The Avery building. The only Trump fire is the one that I hand out when #YoureFired #TrumpRules 	FAVOR
I've come to the horrid conclusion that Conservatives just don't care what the Democrats do. 	NONE
@realDonaldTrump Just want to say thank you for not pandering to the pc police! #richforareason #nofear 	FAVOR
@realDonaldTrump A man who isn't afraid to speak the truth is a man who I'll vote for! Take it home, Mr. Trump! #FuturePresident 	FAVOR
#Obama intervenes on behalf of #Greece = Hello #drachma  Socialism = equality of misery  #tcot #pjnet 	NONE
@GovernorPerry @realDonaldTrump not true Perry! Don't count on me or anyone in my family for a vote. You need to stop being PC. 	AGAINST
In addition to sanctuary cities, I'm done with Walmart too. 	NONE
@Montel_Williams , ex 2bit talk show host, talking shit about @realDonaldTrump . Fuck off montel!! @cnn. 	FAVOR
THE DONALD & CARLEY - Perfect Together! - #Trump 	FAVOR
"Le(a)nin left RT @uss_victory: @realDonaldTrump /#LongLiveLiberty; Better is a ""#Capitalist"" for President than a #Communist. "	FAVOR
I nominate Donald Trump for the new ambassador to Mexico. #Mexico #Tacos 	AGAINST
Stop thinking you can walk around talking reckless in the end it will bite you in the ass #Dontjudgeme 	AGAINST
@politico is there anybody more sue happy than this fool? #trump #lawsuitabuse 	AGAINST
@FoxBusiness I would have to say that #NYSE would never admit a hack. 	NONE
IF Trump could build the WALL it would provide jobs & also B a tourist attraction & pay 4 itself LEGALS arent the ones offended! 	FAVOR
Miss USA host De la Fuente quits pageant and call @realDonaldTrump ignorant and a clown... 	AGAINST
@realDonaldTrump @PamplinFilmCo We needs some Ballz back in the WH.. 	FAVOR
@realDonaldTrump Stay the course! You can win! The USA needs your leadership and competence! 	FAVOR
@ChristieC733  YES DONALD U R 100% CORRECT' as long as u stay the coruse and don't pander to GOP U GOT MY VOTE 	FAVOR
they legalized gay marriage???!!!  what's next?!?!? CRACK?!!!?  	NONE
Dear Republicans: Please nominate Donald Trump. The reminder that people like him exist will do wonders for the progressive cause 	AGAINST
@exjon @SweetFreedom29 @irishspy @KATUNews say's it all!!!!!!!!  	NONE
@liberaltreason @msnbc maybe all the politically correct pansies out there will move to a different country if Trump gets in!!!:) 	FAVOR
Oh my if Hillary Clinton wins the U.S is going to fall apart 	NONE
@realDonaldTrump first time voting and I'm definitely voting for Trump 	FAVOR
#presidentialelection2016  Make plans to help your future now, so that later you don't regret it, again! Vote @realDonaldTrump 	FAVOR
@loudobbsnews Don't you just love that truth is now called controversial comments?!  Has this country fallen that low?! 	AGAINST
He doesn't care & would have to give up TV gigs anyway to run... loves attention & controversy  	AGAINST
@realDonaldTrump Canada supports you! Please stop the ILLEGALS at your boarder before they get to ours. 	AGAINST
"@TuckerCarlson #GayMarriage is the ""law of the land"" yet #immigration law is ignored. Absurd! #LobotomizedLiberals #LiberalLogic "	AGAINST
@realDonaldTrump Probably because @jorgeramosnews had to change it after you published his old one on Instagram #TrumptheChump 	AGAINST
Really #DonaldTrump, all Mexican people are rapists, but you assume SOME are good people... #IdiotNation #facepalm 	AGAINST
@VLActionFund @Reince The same #RNC LOSERS that thought Romney & Palin were good choices needs to be THANKFUL Trump came along  	FAVOR
@RNRWestVirginia @RedNationRising Please go away Pataki. 	NONE
@realDonaldTrump we need someone like you who won't back down to ANYONE or ANYTHING 	FAVOR
"Have you noticed how often the concept of ""living within your means"" is now described as ""ruthless austerity?""#tcot "	AGAINST
I love how everyone thinks canceling @realDonaldTrump's ventures will do anything but hurt themselves. This man has my vote! 	AGAINST
If @Macys wants to try to stall this country's progress that's their prerogative but I'm done shopping there #BadBusiness 	AGAINST
@theblaze American ppl are prolife, anti #Obamacare, pro #bordersecurity pro traditional marriage. Where has that gotten us. 	AGAINST
Right on @ericbolling Racial fatigue and real depression is running rampant in our country these days.  	NONE
Reminder: DemocRATs STOLE  $716 Billion from Medicare f/ the elderly & gave it to Medicaid to help pay for #Obamacare. 	NONE
Cancel your Netflix subscription and donate to @realDonaldTrump's campaign for entertainment #Trump 	AGAINST
Comments by @realDonaldTrump were hateful & disgusting. Everyone should sever their ties with him. Thanks @Macys @Univision @nbc 	AGAINST
Thanks to @realDonaldTrump our Hispanic community finally has woken up from the dead! #GovernmentAndPolitics #WhiteHouse 	AGAINST
Donald trump is way better than ANY candidate out there. Because he's real, not a lobbyist backed puppet #Election2016 	AGAINST
@JVER1 @tgradous @LVNancy  I blame her death on the @potus he is directly responsible. He is pathetic. If i were her dad.... 	AGAINST
"Obama strategy: Open our borders to change our culture  fundamental transformation into Tijuana!"" #tcot "	AGAINST
#TheFive Geraldo is an ass and when he spews his leftist BS he makes me sick TURNING OFF THE FIVE #TheFive 	NONE
@ErinBurnett #cnn WHY WOULD IT HURT @realDonaldTrump TO SAY SOME ILLEGAL IMMS RAPE? @JOHN_WALSH JUST SAID IT'S TRUE @OutFrontCNN 	FAVOR
@LindaSuhler The smear campaign from RINO Headquarters --> @GOP  has begun. 	NONE
I'm developing my own version of Arya's kill list, but for asshole celebrities #BillCosby #PaulaDeen #JaredFromSubway #GOT 	NONE
Donald Trump needs to stop embarrassing himself. Racist assholes.... 	AGAINST
@RoughHouse_Ent Who the hell wants to watch this without 	NONE
Trump: Chicago is a great city. I love spending time in my building. 	NONE
,@realDonaldTrump trumps presidential dreams r about as real as KimJonguns unicorns. 	AGAINST
GOP candidate predictions? America decides to play the Trump card and go with the man with the plan. 	FAVOR
@GloriaAllred is a media whore, but I'm rooting for her and her clients against 'alleged' drug-rapist #BillCosby #tcot 	NONE
American's, do you think we are headed in a positive direction? #USAGuard #OPACT 	NONE
"Me: ""That asshole with the toupee was talking again and it was stressing me out""  Dad: ""Who?""  Mom: ""Donald Trump "	AGAINST
@Newsmax_Media  I bet the @realDonaldTrump does. This man knows how to save our country w/o tiptoeing around, playing games. 	AGAINST
Political correctness should be an automatic disqualifier for all #GOP candidates in 2016. #tcot #DefeatCommunism 	NONE
@realDonaldTrump you work on the Mexican wall and I will focus on the Canadian wall!! #trueenemy #Christie2016 	AGAINST
This country needs a President to take control, cut through the BS, and speak the truth! #truthhurts @realDonaldTrump 	FAVOR
@realDonaldTrump I recommend @seanhannity as Sec of Defense and @marklevinshow as your new Atty General. 	FAVOR
You know Donald Trump is in deep when most Neo-Conservatives call him out on his bullsh*t speech. 	AGAINST
I feel dumb that I am so broke and Donald Trump is a billionaire. 	AGAINST
Donald Trump is in dire need of a crisis communicator. PR folks, please give him your two cents. #SorryNotSorry 	AGAINST
And America wants to protest a silly flag but lets pro athletes get away with shit like that 	NONE
"@realDonaldTrump has formed the ""Racistublicans"". The political party for old fat assholes. #Racistublicans  #Republicans  "	AGAINST
"The #Obama Presidency: Has There Ever a Point in Time When He HASN'T Been Lying to #WeThePeople? RE: The ""Liar-in-Chief "	AGAINST
@realDonaldTrump we all want you as the next president !! You tell it has it is and not as a spineless politician! 	FAVOR
