@tooprettyclub Are you OK with #GOP males telling you what you can and can't do with your own body? 	FAVOR
If you don't want your kid, put it up for adoption. #sorrynotsorry 	AGAINST
"@RedAlert -there should be a ""stigma"" to butchering pre-born children - its a horrendous crime against humanity.  #murder "	AGAINST
Lmao my school thinks giving women the right to an abortion is against feminism. They don't know feminism #wtf 	FAVOR
@AsaSoltan putting abortion in with choices for women just won my heart over. Yaaaaaas! #shahs 	FAVOR
Last meeting of the year tonight! 7:00 pm in Case Hall room 334A. Come one come all! Pizza and pop will be provided! 	NONE
Planned Parenthood lines its pockets while sacrificing women and children in need at the altar of abortion. 	AGAINST
we remind ourselves that love means to be willing to give until it hurts - Mother Teresa 	AGAINST
Life, what a beautiful choice. Adoption. Not abortion. 	AGAINST
My teacher today basically said that embroyo's are nothing but skin + blood & that abortion was fine. #smartlady 	FAVOR
@ShowTruth Keeping pregnant people safe is a great reason for abortion, though. 	FAVOR
@rosaryrevival When we #PrayTheRosary lest we forget to #Prayforpersecutedchurch #PrayForIsrael #PrayForUkraine 	NONE
"Yep. RT: ""Defunding PP won't mean fewer abortions. It will mean more dead women. #prochoice"" #1in3 "	FAVOR
@mrprolife You would force a woman to risk her health, sanity, and life, to continue a doomed pregnancy. Against her will. No. 	FAVOR
Whether someone wants to have children or not should be completely up to the person carrying that pregnancy... 	FAVOR
I will agree to gay marriage if you agree to pro-life and then adopt babies that would have been aborted. 	AGAINST
Too far? Sorry so is he 	NONE
I watched #AfterTiller and it gave me a whole new perspective on a woman's right to choose. #womensRights 	FAVOR
@explicit0ceans I don't either. Why would you want to make people have kids? Esp when they're not prepared? Makes no sense. 	FAVOR
Equal pay for equal work? YES. Freedom from the fear of rape and sexual objectification? YES. The 'right' to abort? NO. 	AGAINST
@explicit0ceans whoa whoa whoa. I don't care about you having sex, but when you're pregnant, there's another life involved. 	AGAINST
Sadly, most health insurance plans don't cover abortions, so the price can be quite high.... 	FAVOR
@Britt_Ghiroli @mboyle1 But the Mayor of Baltimore said to give rioters to rioters. #BlackLivesMatter #Except2Democrats #Sanger 	NONE
It is so much fun having younger friends who are expecting babies. #beentheredonethat #chooselife 	AGAINST
I refuse to let people like you shame and insult women for accessing healthcare. Sorry. Just no.  	FAVOR
pro-life? no you're more pro-birth then after that the baby can support itself!!! #makesnosense #prowomen 	FAVOR
U know what isn't funny? Male politicians deciding what women should do with their body's. 	FAVOR
I was born 4 months premature... I'm perfectly fine, somehow killing babies is legal in this country. 	AGAINST
"@Corey_Frizzell @PEILiberalParty and most Islanders have different definitions of ""timely access"". #irony #peipoli #peivotes "	NONE
I love how #liberals only accuse #conservatives of war on women when we don't want to fund 	AGAINST
Help your friend figure out how they're going to get there and where to stay if they need to spend the night 	NONE
I really don't understand how some people are Pro-Choice. A life is a life no matter if it's 2 weeks old or 20 years old. 	AGAINST
Let's agree that it's not ok to kill a 7lbs baby in the uterus @DWStweets #DNC #Clinton2016 @HillaryforIA #ProCompromise 	AGAINST
"@glennbeck I would like to see poll: How many abortion doctors have told a woman ""No, an abortion is not required in your case. "	AGAINST
"Democrats are always AGAINST ""Personhood"" or what they perceive to be legislation to recognize #Personhood. Always. #Colorado "	AGAINST
"@CultureShifting ""If you don't draw the line where I've arbitrarily drawn it, you can't draw it anywhere."" Nonsense. "	NONE
"RT @createdequalorg: NEW video: ""I'm not seeing it as a human being."" @StandTrue @liveaction_news @collegefix @LifeSite #prolife... "	AGAINST
Someone snitched on the mom having sex with and playing naked twister with teens. I bet it was her Cock blocking ass children. 	NONE
#SB724 passes Sen. Judiciary Cmte.This bill is an effort to shame women out of their personal, private medical decision to have an 	FAVOR
RT @GrumpyOldGuy2: #DebbieWashermanSchultz the woman has a voice the doctor has a voice. Who speaks for the baby? I'm just askin. 	AGAINST
A needed, safe medical procedure is available to women. Unfortunately, RW men say they should make women's decisions. Sad, huh? 	FAVOR
"RT @ProLifeYouth: ""It seems to me clear as daylight that abortion would be a crime."" -Ghandi  #ProLifeYouth "	AGAINST
@LilaGraceRose defunding PP won't mean fewer abortions. It will mean more dead women. 	FAVOR
@LuM1996 @KurtSchlichter #Obama cares more about deserters than unborn babies #ProtectTheUnprotected #AntiAbortion 	AGAINST
Dear Nuns, your advocacy of tax paying is weird. #war #Iraq #deathpenalty #taxespayforthistoo #TaxpayerPride 	NONE
I've noticed that everybody that is for Abortion has already been born-Ronald Reagan #LetthemLive #AllLivesMatter 	AGAINST
Patient advocate Stephen Casey of Texas Center for Defense of Life strongly supports #HB3074. #TXlege 	AGAINST
Are the same people who are red faced and frothing over abortion also against the death penalty? Just wondering... #deathpenalty 	FAVOR
@AzzarelliJim Not so great for the women you want to force to give birth against their wills. #rapeculture 	FAVOR
What a great day to argue the benefits of making abortion legal 	FAVOR
People who want kids can b prochoice. U don't have to want an abortion to b prochoice. People who had a miscarriage can b prochoice 	FAVOR
@HillaryClinton Don't you mean to say (all children deserve the same chances) except the UNBORN CHILDREN?     	AGAINST
Assaulting & manipulating pregnant people doesn't reduce 	FAVOR
People who have never had an abortion can be prochoice. People with a uterus can be prochoice. People who never want kids can be 	FAVOR
@jemimakirke my hat is off to you for speaking out about something that is rarely discussed by anyone who has a voice. 	NONE
Anti-vaxxers are such an idiotic bunch... Seriously, guys. Vaccinate. Your. Kids. #stopsb277 #conformcomics #marvel #dc 	NONE
I know what's best, for my health. You don't know anything about me.  	FAVOR
Some people are not ready for a child or they were even raped, and theres already too many kids who need adopting anyway 	FAVOR
@TheFullBug Dehumanizing? Why are you dehumanizing the pregnant person? They're more than walking incubators, and have rights! 	FAVOR
The Democrats just gave the most chilling reply when asked if they support aborting 7-pound babies 	AGAINST
Up at this ridiculous hour to #protectthezone.  #Alabama 	NONE
Good morning @JustinTrudeau. Do you plan to tell @WadePEILiberal that women on PEI deserve the right to choose? #cdnpoli #peipoli 	FAVOR
Excellent 'speed-dating' #ethics discussion today in Yr9 class #morality 	NONE
UB Students for Life and @createdequalorg are currently on North Campus by the Student Union speaking out against 	AGAINST
@sinnfeinireland  SinnFein voted to kill unborn sick children 	AGAINST
BRAVO TO BOTH OF YOU BEAUTIFULLY EXPLAINED HOLD UP #humantrafficking bill @SenBlumenthal @DickDurbin #womensrights #righttochoose 	FAVOR
Unthinkable, shameful, acceptable, encouraged, desirable  ...the evolution of killing the defenseless.   @msnbc @jemimakirke 	AGAINST
@AdamMyerson @quarq - Sent mine two days ago.  Expect it back in two days. Quick turnaround and great customer service! 	NONE
Both Democrats and #IslamicState murder by dismemberment. The only difference is the age of their victims. #ISIS 	AGAINST
@DWStweets @RepDWStweets is a seven pound baby murderer. Too bad her Mom didn't have the same operation. #Baby #Democrats #Losers 	AGAINST
WH: Motherhood's a Wage Penalty. So we pay em to have kids & we pay em to kill premature babies. WTF's point here libs? #PJNET 	AGAINST
Hillary wants to be a champion for women, unless they're unborn.  	AGAINST
@BuckSexton of course we want the Feds to puff puff pass! #TeamBuck #warondrugs 	NONE
like i really need to walk past a bunch of aborted babies to get into the union. get out of my peripheral 	AGAINST
I think Marcus is slightly scared of my radical liberal side #feministally 	NONE
So ready for my abortion debate  	NONE
We have the duty to protect the life of an unborn child. --Ronald Reagan #ccot #gop 	AGAINST
Some Bitches be scared to kill a little cockroach in their house but quick to kill a baby... 	AGAINST
@tonylee01979 make their own decisions doesn't mean you need to harass me . Goodbye now. #freedom 	NONE
Is there a gas that increases self-mutilation (tattoos, piercing, drugging, over-eating, & suicide) & violence? #waleg 	NONE
@Loriisright @DWMcAliley1791 @LitaZahn Yup. One of the MANY reasons I changed parties. 	NONE
Oh look!!! So not only are antichoice strongly against pregnant people's human rights, they're also homophobic. Shocker. (Not) 	FAVOR
@mrsdrjim did you know #wrp @BrianJeanWRP tried to get personhood going via federal #motion312. 	NONE
How ironic is it that im sitting in @PPact & swiping on @Tinder right now? 	NONE
Pro-choice is pro-murder couched in liberal rhetoric. 	AGAINST
Like ya'll can try and push your views on me anyway but I will remain 	NONE
wow all these people r so upset over 1 Black Man killed, what would they do if they knew about BlackKids killed by #BaltimoreRiots 	NONE
@GolfProYYC every time @TaylorMadeGolf pops up I think its you posting. #dyslexic #oneinthesame  	NONE
@ShowTruth No, I can't explain why you would consider a medical procedure that leaves the patient healthy & happy as killing. 	FAVOR
@notmuchelse you want the freedom to murder a baby. Rip them limb by limb. No change in subject by me.Libertarian 	AGAINST
@ProWomanChoice forcing women to change their body's normal function is the epitome of controlling women. 	AGAINST
Watching teen mom and watching Farrah be a bitch makes me believe in abortion that much more. 	FAVOR
@AMLiveNTV:  its morally wrong. Life is sacred and only the giver and its onlyHim alone that should take it#HaveYourSay is on 	AGAINST
She has a brain, a heart, and her own unique DNA, not her mother's. She is alive and human. Please don't kill her. 	AGAINST
Agree choice if woman's life in danger.  But rape - does the baby deserve death for crime of his/her father? @HelpBillColeman 	AGAINST
@LifeNewsHQ What could have happened in her past to make her the cruel & frighteningly hard-hearted woman she is? #waronwomen 	NONE
Joining us in studio is Amos and Josh on Music and Career with Kobi Kihara #Bands 	NONE
What is the difference between a baby and a onion? No one cries when you chop up the baby.   Hahahahaha! Love dead babies! #Babies 	FAVOR
Pro-Choice is meaningless. Say what you mean. You stand for the right to choose to kill. 	AGAINST
Kudos to the mentality that believes people who are dumb enough to not use protection are 'mature enough' to take care of a baby. 	FAVOR
I just want to sit in a corner and cry.  I wish I was a thicker-skinned feminist but this shit is personal! #MyBodyMyRights 	FAVOR
@Fredindimuli  yes he has an opinion but the choice should be in the hands of the women You know the person directly affected? 	FAVOR
Gov Brownback visits cities in #Kansas 2 sign new #bill  #woman 	NONE
I refuse to stop praying for an end to abortion. 	AGAINST
"@BBCNewshour ""if u had been my wife I would have blow your head off."" Yep, that sound like #ElSalvador "	NONE
@smalldoctor15: What is postinor popularly used for? 	NONE
"@WayneSense ""In check"" is putting it nicely. #MargaretSanger "	NONE
@ProLifeLiberty Yes, your reasoning is horrible. We were talking about abortion, not death. 	FAVOR
Idiot: how would you feel if your mom aborted you?  Me: nothing cause I would be fucking dead. 	AGAINST
@LifeNewsHQ  22wks is too late to be able to have a termination in my opinion, these triplets are babies not a bunch of cells. 	AGAINST
Dude i won a #freeshirt from @abort73 ! I never win anything lol #Abort73 	NONE
Praying for that innocent lady. She's a victim too. I hope the execution will not proceed. #NoToDeathPenalty #SaveMaryJaneVeloso 	NONE
@politicspizza @RebeccahLouise @ProLifeYouth women being independent and making their own CHOICES 	FAVOR
When is abortion a responsible choice? When a woman chooses it to be 	FAVOR
@charulife And I explained that they are in the keep your baby business, as they helped me get Medicaid and WIC. 	AGAINST
Today, AB 775 passed out of Committee on Judiciary 3-7. We will let you know how to help! 	NONE
"@WildChild69 Typo - I meant to say ""dies"" - With every abortion @ least one human dies. "	AGAINST
RT @alvedaking: The most disturbing thing we to this planet is to flood our streets with the #blood of #children from #HappyEarth... 	AGAINST
RT alvedaking: The most disturbing thing we to this planet is to flood our streets with the #blood of #children from #HappyEarthD... 	AGAINST
RT @PinkGypsySoul: The single most important factor for women's advancement in society is our ability to control our fertility. 	FAVOR
people in the government care more about words in a bible than women and their bodies 	FAVOR
RT @spicysandwich: Say it again for me one time!  Anti-abortion laws only lead to unsafe, illegal abortions! 	FAVOR
Preach! 'Black Sheriff Says if  #BlackLivesMatter,  They'd Protest at Abortion Clinics'. #ChooseLIFE #AllLivesMatter 	AGAINST
"@gvandersee 100,000 (estimated) ozzie abortions of vulnerable, unwanted ""unlife""  right there. Value & Respect life. #deathpenalty "	AGAINST
If you aren't responsible enough to take care of a baby, why are you having unprotected sex? 	AGAINST
@kugrl6 good riddance to millions of black babies? I really hope I'm misunderstanding you 	AGAINST
RT @gbforchoice: When is abortion a responsible choice? When a woman chooses it to be 	FAVOR
#BlackLivesMatter unless they are pre born black lives then they don't matter #AbortionIsMurder #LiberalLogic 	AGAINST
I am just as much a feminist as any pro-choicer. I simply carry my beliefs to their logical conclusion. #faminism #YesAllWomen 	AGAINST
@emrata did u become a lib before or after u made it in Hollywood? #BlackLivesDontMatter #whitebrunch 	NONE
 If abortion is not wrong, then nothing is wrong.   Powerful words from Blessed Mother Teresa.    	AGAINST
@Stuart1927 @GoodCounselNet Thank goodness politicians saw sense and recognised women's rights over their own bodies. 	FAVOR
RT @DogsOfGod: I will fight for the unborn! 	AGAINST
Women's rights are a joke.  Omg I can't even. Lol go thank your mom for keeping you. 	AGAINST
We are the #prolifegen and we will abolish abortion in our lifetime! #prolifefuture #tcot 	AGAINST
Abortion does not make you un-pregnant, it makes you the mother of a dead child.isright 	AGAINST
Abortion has nothing to do with feminism. Its about the BABYS body, not yours.isright 	AGAINST
@peiacsw please consider the status of preborn girls as the most vulnerable women in society. #peivotes 	AGAINST
@abc13houston Don't Let Obama Control Your Actions. Progressives have destroyed the Black Community #LBJ #Clintons #Drugs 	NONE
Pro-Life Legislative Day Party in Lansing today! See y'all there! #sopumpedgen 	AGAINST
@Hannah_Warren14 that much more oppressive for women 	NONE
"I will believe the narrative that ""black lives matter"" when ALL black lives matter, all the time. #BlackOnBlackViolence "	NONE
@hillaryclinton - I guess this means you're happy for me to be pro-life as I never aborted any of my own children? #hypocrisy 	AGAINST
People who have been pregnant can be pro choice. People who can't have kids can be pro choice. People who have a uterus can be 	FAVOR
Lol it's no ones choice but the woman's when it comes to abortion. Men shouldn't even be able to vote on the issue. 	FAVOR
What doesn't reduce abortions: -Making it illegal  What does: -Sex education  -Caring about the pregnant person... 	FAVOR
Changing the cis-nomative atmosphere is difficult.  	NONE
@CrushTheCFR Yes, heard you the first 500 times you tweeted SIX kids. she is probably also 	NONE
We must provide demonstrated sexual training as a preparation for marriage. From THE COMING WOMAN #sexed #marriage #books 	NONE
@EmilyBeaulieu1 maybe that's what he wants 	NONE
She*  knows what's best for her* happiness & her* body 	FAVOR
words are meant to trigger strong emotional responses as well as to the medical inaccuracies & misogyny.. 	NONE
As good a time as any to say: when too many men are adjudicating on women's reproductive systems, the results are never good #Rape 	FAVOR
Thank you @PPact for treating me with kindness & respect & TLC during my wellness exam. #womenshealth #yaycondoms 	NONE
"Your life is worth a lot. Don't believe any ""compassionate"" politicians or doctors or friends who tell you otherwise. You matter. "	AGAINST
@charlescwcooke @HillaryClinton Once they're born, that is. 	NONE
Re Last: I can't get past this...why must abortion providers dismember a fetus alive?  That just sounds...hideously inhumane. 	AGAINST
Praise to District Court Judge Larry Hendricks for blocking that ridiculous anti-abortion law in Kansas 	FAVOR
@m_lonz @LifeNewsHQ Captors have already been born and are no longer part of the body of a pregnant woman. That's the difference. 	FAVOR
The right to #choose? Thats a #lie! #babies don't choose to #die! Prolifeyouthgen 	AGAINST
It's not #yourbody, so it's not your #choice.youthgen 	FAVOR
Even the #smallest #person can change the course of the #future.youthgen 	AGAINST
The right to control one's body is not a license to kill.Youth 	AGAINST
Does a #pregnant #woman have 2 heads, 2 hearts, 4 arms, and 4 legs? #prolifeyouth #prolifegen #didntthinkso 	AGAINST
Since #roevwade 1/3 of my #generation has been #aborted. Where were their #rights?youthgen 	AGAINST
How can there be too many #children? That is like saying there are too many #flowers -Mother Teresa #prolifeyouth 	AGAINST
Pretend I'm a #tree and #save me. -babies everywhereyouthgen 	AGAINST
If it isn't a #human life then why does @PPFA have a problem with us?youth #itisahumanlife 	AGAINST
The answer to a #crisis #pregnancy is to eliminate the crisis not the #child.youthgen 	AGAINST
Legalized tweeting-instead-of-procreating discriminates against the unconceived child. #worstargumentever #lolanti 	AGAINST
Call me an #extremist, but I think #dismembering babies is wrong.youthgen 	AGAINST
@DardenMBA As a former fetus I oppose #ProlifeYouth 	AGAINST
They haven't eliminated #murder. They just call it by a different #name. #prolifeyouth #prolifegen 	AGAINST
One, we are pro life Two, a little bit louder Three, I still can't hear you  Four, more more moreYouth 	AGAINST
I'm a woman who cannot conceive, and I proudly beg you to reconsider killing what I'd die for.               #ProLifeYouth 	AGAINST
Abortion is legal all nine months in Canada and in some parts of the USA. #ProLifeYouth 	AGAINST
@kilcurry in those hospitals that signed up to the legislation. 	NONE
It's time to be a #voice for the #voiceless. Stand up for the #unborn! #AllLivesMatter #ProLifeYouth #chooselife 	AGAINST
I am a man, but I feel most qualified to make healthcare decisions for women.   #ThingsYouDontSayAsAPolitician 	AGAINST
This is a debate about our understanding of human dignity/what it means to be a member 0 the human family/even tho tiny, powerless. 	AGAINST
"RT @OurBrother1: ""A nation that kills its own children has no future.(On Abortion) ~Bl. John Paul II "	AGAINST
Will you be my #voice? -unborn babiesyouthgen 	AGAINST
Had a great meeting today with two guys who I know are reading this tweet... Welcome to the team! Excited to expand Team Sobhy!!  	NONE
I can tell women what to do with their bodies  #ThingsYouDontSayAsAPolitician 	AGAINST
@umich Unjustified homicide should ALWAYS be illegal, including #ProlifeYouth 	AGAINST
The world is waking up to the fact that killing babies is wrong. No matter what. #ProLifeYouth 	AGAINST
"#ThingsYouDontSayAsAPolitician: ""I'm personally opposed to #abortion, but...""  Abortion is WRONG. Period. youth "	AGAINST
Why don't black lives matter in the womb? 	AGAINST
@LogicOfLife7 I don't think I have a right to use someone else's body without consent. Do you? #rapeculture 	FAVOR
"@LogicOfLife7 Premise is wrong. Nothing on earth has a ""right"" to use someone's body w/out consent. #rapeculture "	FAVOR
@UCBerkeley No Such Thing As An Unforced #ProlifeYouth 	AGAINST
In Ireland the unborn child has constitutional protection. Long may this continued.Youth 	AGAINST
#ProLifeYouth have no chill, and we're dang proud of it. Human rights injustices should never be treated lightly. #prolifegen 	AGAINST
#ProLifeYouth if you are truly a feminist you would be fighting for the woman's life that is in the womb. #AllLivesMatter 	AGAINST
@kfadich Every sperm is apparently sacred, and entitled to use of someone's body. #rapeculture #worstargumentever 	FAVOR
@k8write95: 1/3 of my generation is missing. And it can't be changed. But we can change the future.   #ProLifeYouth 	AGAINST
@prolife_wife Yup. The women in the womb are as precious as those who are outside of it. #ProLifeYouth #AllLivesMatter 	AGAINST
Size,Level of development, Environment,Degree of dependency do not affect a human's value. . A fetus is a human being #ProLifeYouth 	AGAINST
#Abstinence proponent #BristolPalin, pregnant with second child, conceives of #humility.  #MirthControl #BirthControl 	NONE
Your life, your body, your choice.  #womenshealth #womensrights 	FAVOR
@CandiesOrg Oops she did it again Bristol is PREGNANT. Candies is a waste.  U paid her 400,000 for WHAT? PPL Send ur $ to 	NONE
"I get the whole ""Kill your darlings"" advice, but I feel like an abortionist with all these unfinished stories. #Writing  #Literary "	AGAINST
Bristol Palin doesn't want any lectures, you guys. That's her job. #hypocrisy #15minutes 	NONE
I don't plan on ever having an abortion, but here's the thing ...I don't think anyone ever PLANS on it. 	FAVOR
My body, my life. You fuck it up in a way I'm not prepared for and I will kill you. 	FAVOR
Messed up: Being outraged that it's legal to distribute images of abortion, but being fine with abortion being legal. #No2Trudeau 	AGAINST
@crazygranny56 More #blacks killed by abortion than during #slavery #ConfederateFlag 	AGAINST
Dear #BristolPalin. STOP. Just FUCKING STOP. You have choices. It's called #abortion. Take it or leave it but quit whining. #fem2 	FAVOR
No ones fenna die from this heat on my watch. 	NONE
Undergirding every important issue today is this:  what is truth?  #marriage #racism #gender 	NONE
Of mothers advising their daughter's to abort are insane! It's unacceptable!! #Condoms #ItsNotOnItsNotSafe 	AGAINST
@BristolsBlog second out of wedlock pregnancy and you don't want a lecture, you just want to give them? STUNNNG. 	NONE
"@LifeMattersJrnl Once again, whose body do you have a ""right"" to use w/out consent? Still waiting. #rapeculture "	FAVOR
Why would a mother advice her daughter to abort?? Shame, responsibility, but truly is that the best advice?? #ItsNotOnItsNotSafe 	AGAINST
Well now that marriage is out of the way we can focus on abolishing abortion, stoping the murders of unborn children 	AGAINST
"Hey, #BristolPalin, when Alaska asked you to promote ""wide open spaces,"" pretty sure they were talking about the state. "	NONE
Woah the hashtag puts the rainbow heart itself there that's weird #butimnotgay 	NONE
Just owned a woman who works for planned parenthood. #factsonly 	AGAINST
If it's getting old maybe you should stop calling embryos & fetuses babies. 	FAVOR
@_hannahwilhoit @paigem32 I'm done with the convo. But before I go. 	NONE
Ok now how about we handle up on something just a little more important.....like MURDER   	AGAINST
@WhiteHouse  @POTUS All children except the millions that have been aborted #everylifematters 	AGAINST
The only solution I see against the #POTUS #SCOTUS #Tyranny is #ArticleV #FederalistPapers #SCOTUScare #GayMarriage #wtf 	NONE
Why do you cry when a dog dies in a movie, but it doesn't seem to phase you that so many babies die because of abortion?  	AGAINST
It's so brilliant that #lovewins - now extend the equality to women's rights #abortionrights 	FAVOR
Can we get a law for the little ones who can't even speak for themselves? #ProLifeYouth #EVERYLIFEMATTERS #gay #straight #baby 	AGAINST
They made same sex marriage legal but they won't make abortion illegal. What is wrong with this world?  #adamandevenotadamandsteve 	AGAINST
Now we just need to give women everywhere their rightful choice 	FAVOR
"Selfish men everywhere: ""#BirthControlHelpedMe cheat on my wife! But she found out anyway & our marriage was destroyed. "	NONE
@SuePalmers @LSDsr Nothing to do with me.  It's not my choice, nor is it yours, to dictate what another woman chooses. #feminism 	FAVOR
So can unborn children have rights now? 	AGAINST
@TheReadClub He who wears the shoes knows where it hurts but I'm Pro-life. #TheReadClub 	AGAINST
Good reminder that over 57 million children have never been granted the opportunity to share the air we breath. #Equality 	AGAINST
@mrprolife Complications come with all types of medical procedures, doesn't mean procedure itself should be banned. #DealWithIt 	FAVOR
"Any asshat ""protesting"" against @SofiaVergara is a disgrace to the entire Women's rights movement. Live and let live. "	NONE
"Any asshat ""protesting"" against #SofiaVergara is a disgrace to the entire Women's Rights movement. Live and let live. "	NONE
@abelitomiranda ...about the millions of aborted children? Lets fix this too #LoveWins 	AGAINST
@ArkBuilder17 we may disagree but I love ya man I don't want hard feelings 	NONE
Abstinence spokesmodel and brawler, Bristol Palin is pregnant and not at all happy about it. Poor little rich girl! #Hypocrite 	NONE
If you want #Equality then let ALL the babies live!! 	AGAINST
Now the matter of abortion comes next. 	NONE
@TheHeavySquad  #DailyWordsOfWisdom Pat's best Hell is for children  still defines goverment #fostercare #adoption 	AGAINST
Equality in the states is a nice step forward to a better America. #ProudToLove 	NONE
RT @rxchelredekop: Consenting to sex is not consenting to being pregnant!!! Like!!! No!!!! 	FAVOR
Bad 2 days for #Kansas Conservatives #ksleg @govsambrownback going 0-4 in courts #SCOTUSMarriage #SCOTUScare #schoolfunding #sweep 	NONE
Now that there's marriage equality, can we start working on equal rights for unborn children? 	AGAINST
@web_rant No, it shows that liberals should start thinking about the consequences of their actions #polygamy #gaymarriage 	NONE
"@BarackObama celebrates ""equality"" while 3000 unborn babies were killed today. Let's talk about a real inequality sir #LifeEquality "	AGAINST
So unfortunate #thebriefcase @cbs. Adoption isn't always the answer. 	FAVOR
Now that the govt and The Supremes have saved the gays, maybe they will save the babies next. 	AGAINST
Part of our celebration will be dancing our butts off to a LGBTQIA pride inspired playlist. What songs should we add to our list? 	NONE
@conspiracyimage @ThislsAmazing actually noone said they dont consider it life, and an abortion is between a woman and her doctor 	FAVOR
@michaelianblack i don't follow the news, is there a new law that ALL gay people have to get married? I'm against that! 	NONE
"True equality"" allows all to be born. "	AGAINST
Just a reminder, don't take your eyes off #SCOTUS yet #reprohealth is still on the line. #womensrights #ReproJustice #reprorights 	FAVOR
Can we make sure #lovewins for babies too? Or nah... 	AGAINST
@Caleb_Lopez760 it is legal bro and its 	NONE
Forced reproduction is a human rights violation. #feminism #abortionrights 	FAVOR
WORLDWIDE R.E. Agents! - Support a ProLife Group (U-choose) at NoCost ProLifeRealEstate@Yahoo.com 	AGAINST
I feel the greatest destroyer of peace today is 'Abortion',... Mother Teresa 	AGAINST
@j6fras same but I got hated for it. #progod #progun 	NONE
@Catniptwoshoes @hoursofChaos @bindelj if men could get pregnant things would change pretty quickly! #BackOff 	FAVOR
lifeboatcoffee Thanks for the follow! Done with SB and other companies on the left. All about #1M1W #CCOT 	NONE
RT @ProLifeYouth: #SCOTUS says they support equality for all. Well what about equality for the unborn?  	AGAINST
Manipulation, Disguise, & Evil is always seen by the out-come. The Ugly Doors of Satan appear in all forms when it's Fake Love. 	NONE
In church for a Pro-life meeting. I will be the voice for the unborn. #SaveTheBabiesBumpThemAnimals #GodIsLoveSoLoveWins!! 	AGAINST
We should not deny the basic human right to life for unborn babies. #LifeWins #EndTheDiscrimination 	AGAINST
@KC_Football_Guy I am all for focusing on things that matter. #ISIS #Racism #Immigration #ChiefsKingdom 	NONE
Bigger problems 4 #Christians than same sex #marriage: #worldhunger #cleanwater #sextrafficking #slavelabor #womensrights #thelost 	NONE
There Will Never Be Enough Of Us should be the slogan at 	NONE
I'm so glad this is Not My Home! #NMH #SCOTUSMarriage #ACA 	NONE
There's an undeniable inverse correlation between women's right to choose and crime rates #womensrights 	FAVOR
I wonder if America will like focus on real issues now #starvingchildren #abuse #nationaldebt #terrorism 	NONE
If you're all about equality, then the unborn babies get an equal chance at life too....#EqualityForTheUnborn 	AGAINST
@nytimes Thanks to anti-choicers, women dealing with this may also face prosecution. 	FAVOR
When you abort a baby, you don't just abort one person ...you abort generations. 	AGAINST
Abortion is on the wrong side of history: healers, inventors, artists, your wife, your husband, your best friend, all eliminated. 	AGAINST
Spent the WHOLE day on my highlight film from my Israel trip...I'll post the link and Instagram the link to it  #ballislife 	NONE
if it wasn't for harry all my favorite characters would still be alive 	NONE
Thanks @Jeffrey_Addison  Kudos to @VolvoCarsAus for caring about the safety of unborn children #auspol 	AGAINST
RT @AdvocatesOfLife: RT @ProLifeYouth Adopting a child shouldn't cost more than aborting one.   #adoptionclini... 	AGAINST
On my bday I'm always so grateful to my bio parents who gave me up for #adoption #nochoiceisevereasy 	AGAINST
if we can accept that a mother can kill even her own child, how can we tell other people not to kill one another?  	AGAINST
Girls don't want boys. Girls want 	NONE
Mzwakhe mbuli says doctors & nurses are paid assassins.. they kill unborn babies & give it a fancy name 	AGAINST
People aren't 'pro-life' they're 'pro-birth'. When a mother can't provide what happens then? 	FAVOR
Just remember, there is a living family out there just waiting to #adopt your aborted baby. 	AGAINST
@forrest_grump Large parts of it were difficult to write so I can't imagine having to read the fucking thing. 	NONE
What the leftists are doing is putting all Americans in danger! #tcot #UniteBlue #LoveWins #LGBT #SCOTUS 	NONE
If Doctors used guns to perform abortions, would liberals then be opposed? #2A #liberallogic 	AGAINST
I don't hate LGBT but I disagree with same-sex marriage. #SacramentofMatrimonyisSacred 	NONE
We all have a duty to protect the sanctity of life...from the first cell division, to the last. #ProtectLife #pjnet #ctot #ccot 	AGAINST
(3/3) So when @AUL tells you MLK was #prolife, they're lying. (Their gullible followers r likely just misinformed). #UniteBlue 	NONE
RT @modernwerewolf: Why doesn't anyone congratulate me for NOT getting knocked up? Throw me a damn shower #ReproJustice 	NONE
Time to make a change in my boxing style can u say @GGGBoxing style but still be great on my defense #beastmode #boxing #ximenez 	NONE
We are surprised at #SCOTUS ruling on marriage? Isn't this the the same government agency that legalized murder? 	AGAINST
@PnkGlitterChemE @SayNoToSuicide4 Being #Gay is a #Choice Just like 	NONE
Yo if you decide to set yourself on fire cause gays are allowed to be married, that is 100% your choice and I am in support of it 	NONE
Parents have left their role to the teachers! Parents need to have skills to reach out to their own children it's important! 	NONE
@madisonfletch_ but it's ok. at least it's only yo your hand that smells like dick 	NONE
Hadn't seen October Baby until the other night. Had me crying thru the whole thing...I don't cry at movies. So touching! #adoption 	AGAINST
@StevenWHawkins @AmnestyOnline & yet Amnesty advocates child murder! 	AGAINST
Roe v Wade prevented the biggest crime spree predicted in U.S. history. The guns were there; the criminals weren't. #gunsense 	NONE
@LifeNewsHQ I would consider this, to be dispersal of a chemical weapon, one that kills children. 	AGAINST
.@ChadCottle From 1.4 million/yr to 1.1 million/yr. The ONLY way to make them decline to <5,000/yr is by making abortion criminal 	AGAINST
Pregnancy is not a crisis. It's a gift. Whether they be wanted by you or someone else, no child is unwanted. #ChooseLife #Adoption 	AGAINST
"@Andrea_provida Or another hypocrisy are  those who campaign for animal rights but are ""pro choice"" . "	AGAINST
@CoraSherlock @NORTHANNE @fdelond you Cora ignore that IRE export the 'problem',to UK @MarieStopes #itwontgoaway #repealthe8th 	NONE
Bernadette Smyth is an ignorant thunder cunt.  Not her life. Not her body. Not her business.  #ItsABallOfCellsNotABaby  #NewsNI 	FAVOR
#Liberals don't realize they conceded the debate. Now - per Shaw - we are just going to haggle over price.   #Idiots 	NONE
SCOTUS at it again!  Blocks Texas from enforcing part of new abortion law!  We have to stop killing babies! 	AGAINST
Abortion laws should be designed to make it harder to get an abortion. Abortion is murder! 	AGAINST
@SCOTUSblog My @TheGoodGodAbove, is it 1973 already? 	NONE
Well that's a win for women in Texas. Thank you SCOTUS! #texas 	FAVOR
It's time to end the #deathpenalty in the United States. #wholelife 	AGAINST
abortion clinics... back alleys with a profit center and air conditioning?  	AGAINST
Definitely the #SCOTUS today has landed where women are. #Texas #clinics #issues 	FAVOR
Progress for #AfricanAmericans check. Progress for #Gay people check. Progress for #Women. Waiting waiting waiting.... 	FAVOR
Happy to hear the #SCOTUS blocked closing of 10 abortion clinics in TX until an appeal can be heard #safelegalrare #thinkprogress 	FAVOR
Sweat, killed and cut up his victim, extreme deadbeat parents do the same to innocent babies by abortion, #scotusabortion 	AGAINST
If the fetus isn't inside you, than shut up love 	FAVOR
@jacelarson He's not concerned about women's health, it's all about control. Stay outta my lady parts, Mr. Patrick! 	FAVOR
"How can you be ""against abortion"" and also want to take away all the free birth control clinics for the poor? How? "	FAVOR
@davebachman34 @Clifford1462 @msnbc you know what massively reduces abortion? Sex education and access to birth control. 	FAVOR
#BlackLivesMatter Protesters wd'rather spray paint #Confederate symbols than concern themselves w/ Millions of Black Lives Lost to 	NONE
Coming from a female that was taken away the ability to have children. I still believe women should have the ability to choose. 	FAVOR
@StAlbertCIVC do you have influence on policy on how the info is presented as a whole, given that you are listed as a Partner. 	NONE
@SenatorLankford just a reminder that you are awful in every way and do not represent me. #prolove #proeducation #prohealthcare 	NONE
At the Mass. State House again tomorrow for Planned Parenthood's Sexual Health Lobby Day #ReproductiveJustice #Feminism 	FAVOR
A woman who deliberately destroys a fetus is answerable for murder.-St. Basil the Great 	AGAINST
. . . abortion is not self-defense, shooting the rapist is Kittington #PJNET #TCOT 	AGAINST
#DonRients: people aren't just killed by guns.  9 people died and that's sad.  But how many die daily from #abortion? 	AGAINST
@MarthaPlimpton It's not Monday on Twitter until some right wing troll sends me a video of an abortion #ReproRights 	FAVOR
ALSO what the fuck gives a man the right to tell a woman what to do with her body? If she wants to get an abortion so be it Texas. 	FAVOR
@OnlineForLife thank you for the way you beautifully communicate the pro-life message. You all consistently blow me away. 	AGAINST
@__HisKindaCrazy @_QueenTacoBell @thumperbunny88 Abortion is NOT illegal and I would never judge a woman for making that choice. 	FAVOR
@Anti_Fox_News @MannyMooncup @lexinelli @MattSears4 @FactsVsOpinion Hypocrisy: saying #LoveWins while supporting #QuitKillingGirls 	NONE
The Constitution of Kenya 2010 is clear that abortion on demand is illegal.  #FIDA 	AGAINST
@FoxNews @BristolsBlog Not possible. #BristolPalin doesn't believe in 	NONE
So prolifers are against health rights? 	FAVOR
They know what's best for their safety. 	FAVOR
On my way to Sweden! @LETAccess #womangolf #letsgooo 	NONE
If 'tis not human beings in the womb, how do we harvest and transplant their organs onto human beings? 	AGAINST
Breda O'Brien strikes again, why can't people just allow the woman who is carrying the 'child' to make her own decisions #Amnesty 	FAVOR
RT @Paul71: Who's yer man in the #dail talking about bullying? The only bullying was Fine Gael bullying their own members! 	NONE
Gets rid of a daughter and pretends she never existed. #ParentTrapPlot or 	AGAINST
Abortion does not prevent rape. Kittington 	AGAINST
#Prolife laws kill women. Real #feminists are #prochoice. Calling us #feminazi? Because of course you have no arguments. #fem2 	AGAINST
Demand the Senate vote to ban painful late-term abortions. Use your voice to help hold the Senate accountable. #bluemoon 	AGAINST
We are thrilled to announce that we will be opening a satellite office!  We'll be right across the street from #ASU !  	AGAINST
U.S. Fed law does nothing to prevent killing of pre-born children even up til sec of birth or seriously address root causes of 	AGAINST
Im against abortion & i stand by my opinion. No, its NOT just a mass of cells. 	AGAINST
.@RebeccahLouise I'm not forcing anyone to do anything. Abortion is not 'medical help' & there are better options. Very proud to be 	AGAINST
Murdering an unborn child is the crudest form of contraception! #Catholic #Christian #Conservative #feminist 	AGAINST
Don't see the big deal about all this 	AGAINST
@helenantanova Turning it into a racial thing kek 	AGAINST
@StevenErtelt @GM_GXPfan My wife had an abortion when she was young She regrets it to this day 	AGAINST
@KarrattiPaul @chooseliferacer And gov't $ should never go to the largest corporation that murders little babies. Defund 	AGAINST
How the fuNk is Chris Christy a Republican? Oh Yeah hes a RINO #1A #2A #NRA #COS #CCOT #TGDN #PJNET  #WAKEUPAMERICA 	AGAINST
If men could get pregnant, abortion clinics would be like Starbucks 	AGAINST
In #scotus majority opinion, substitute abortion for capital punishment, and you have the opinion for the Texas clinic case. 	AGAINST
because it is settled that [abortion] is constitutional, it necessarily follows that there must be a means of carrying it out. 	AGAINST
Abortion is not contraception. Contraception is about preventing pregnancy. Abortion is terminating a life.  #CCOT 	AGAINST
@UberFacts because that 9% utilized that wonderful gift of choice (#proChoice). 	AGAINST
@UberFacts because a good percent utilized that wonderful gift of choice (#proChoice). 	AGAINST
I had a word with some of the antiabortion protestors. Calmer after buying bi pride colour yarn for a friend & I. Haberdashery <3 	AGAINST
@usweekly I doubt she was clothed with anything when that pregnancy occurred. 	AGAINST
#Mozambique's new penal code takes effect on Wednesday containing several significant new elements,including #decriminalisation of 	AGAINST
@Esmerald_Kiczek  Rock on girl!  We all know #AbortionIsMurder.   	AGAINST
Abortionists refused to comply with these constitutional, common-sense standards. #NARAL 	AGAINST
There is something very sinister, NAZI-esque, about folks who support killing babies. #qanda #auspol 	AGAINST
How Ohio is secretly as restrictive as Texas with their #antichoice laws #TRAPlaws 	AGAINST
#Florida AttorneyGeneralBondi files appeal after Judge grants ACLU request to temporarily halt new law requiring 24hr wait before 	AGAINST
Plenty of stem cells without baby smashing, by the way. 	AGAINST
@HomunculusLoikm @SawyerAndrew @BryanBroome1 @jstines3 I don't think most women enjoy the experience. 	AGAINST
@HomunculusLoikm @SawyerAndrew @BryanBroome1 @jstines3 Bad analogy. The current time frame for abortion is the best compromise  	AGAINST
@MI_IMMACULATA @GLORYtoGOD_143 @BenignoVito Very important to #PrayTheRosary to #PrayforthePersecutedChurch & to 	AGAINST
#PeoplesDebate Juvenile hysterics from that woman. Killing babies is bodily autonomy? People dying of neglect but lets have #VinB 	AGAINST
#PeoplesDebate Better every child born out of marriage + every mothers get #loneparents allowance than there be a single #VinB 	AGAINST
@toby_dorena I am in favor of women's rights and their right to choose. How I chose is irrelevant to others 	AGAINST
@mrgeology They abort millions of their possible progressives for the future. #Downfall 	AGAINST
@oXGodLessXo @Canuckle_head @Atheist_Roo @atxbantamathy           /gags Dat face. 	AGAINST
@toby_dorena Any pregnancy can turn deadly at any time, without warning. I can't force that on someone. 	AGAINST
The same people that demand gov stay out of their vaginas, demand that gov legitimize their same sex bedrooms! Curious.  #LoveWins 	AGAINST
@ghhshirley Charged with Manslaughter After Another Woman Dies From 	AGAINST
@ghhshirley Abortion Workers Charged with Manslaughter After Another Woman Dies From 	AGAINST
@ghhshirley @WordfactoryQ @LeahNTorres Abortion Workers Charged with Manslaughter After Another Woman Dies From 	AGAINST
@NARAL @TIME At the same time, this decision ISN'T always a difficult one. Don't let #antichoice guilt-trip people. 	AGAINST
If your agonist abortion get a vasectomy  	AGAINST
When you bring up the 50 million black babies aborted in the past 30 years people get offended... 	AGAINST
I am 1 in 3... I have had an abortion #AbortionOnDemand #MenstruationMatters 	AGAINST
How dare you say my sexual preference is a choice, how dare you say dismembering my preborn isn't. #liberalism 	AGAINST
