Always a delight to see chest-drumming alpha males hiss and scuttle backwards up the wall when a feminist enters the room. #manly 	FAVOR
Stupid Feminists, the civilization you take for granted was built with the labour, blood sweat and tears of men. 	AGAINST
YOU'RE A GIRL AND HAVE A SEX DRIVE!? YOU MUST BE A SLUT! #feminist 	FAVOR
Suns out....  Dresses out...  #StreetHarassment out...  This shouldn't be daily life  #YesAllWomen @EverydaySexism 	FAVOR
These pics of #pornstars with/without makeup? Just perpetuating the myth that women need makeup to be considered pretty. 	FAVOR
#YesAllWomen should know how to protect herself. Which is why I carry a gun. #republicanvalues 	FAVOR
tired of anti-womanist respectability politics. we need a safe space for women can look like they're at the club at an interview 	FAVOR
If you're a feminist AND you hate men, please kill yourself. 	AGAINST
Women don't make 75% less than men for the same job. Women, on average, make less then men. Look it up feminazis. #EqualPayDay 	AGAINST
"MRAs just tried to ""enlighten"" me, which went about as well as the flight of the Hindenburg. "	FAVOR
Why do girls/women spend so much time to be pretty and attractive and then complain if they're reduced to a sex symbol? 	AGAINST
@randomtweetor i hate to break it to u bruh but women do get pretty for us. They get pretty to show other women #feminist 	FAVOR
Job should always go to best candidate, regardless of gender. Gender shouldn't even matter anymore, it's 2015! #PaulHenry 	FAVOR
What do you say to a woman with two black eyes?  Nothing, she's already been told twice.   	AGAINST
Did you know? Gender stereotypes as we know then developed with beginning of the 18. century. #gender 	FAVOR
As Chip Kidd announces the readers & asks us to hold their applause, the audience cant hold it back for @GloriaSteinem #poetry 	NONE
Women get paid far more than men to appear in pornography. How come no one is talking about this blatant sexism?!  @amazingatheist 	AGAINST
You know you're in a patriarchy when women are the ones who are blamed for prostitution #whatisjustice #inequality 	FAVOR
When is it ok for a married 49-year-old CEO to use his power and influence to shag his 22-year-old intern? #AskHillary 	FAVOR
I love that girl @EricWynalda on @meganrapinoe_15 What the hell @FOXSports1? Way to diminish women's soccer #USWNT 	FAVOR
Men don't have a right to talk over you, you're voice is important, you are a goddess and don't deserve to be silenced 	FAVOR
FINALLY A WOMEN RUNNING FOR PRESIDENT 	FAVOR
"Pissed that I got ""talked to"" but he didn't  "	FAVOR
I believe that every women should have their own rights!! 	FAVOR
I am obsessed with becoming a woman comfortable in her skin.  Sandra Cisneros #latinx #woc 	FAVOR
Extinction of insects,dangerous herbs,gigolo services,religious fanaticism,fake BEERcans-Y Malaysia Radio&media FAIL2discuss? 	NONE
.@MyRainbowNinja @NotAllBhas This farm is fucking disgusting. 	NONE
@FudgieeBuddiee ARE YOU SAYING ALL GIRLS ARE SENSITIVE BECAUSE OF GENDER ROLES? YOU SEXIST SWINE 	FAVOR
"@DaniBChristen Yes,a ""greater"" understanding because ur's is ""superior"" 2 mine LOL #IDontNeedFeminism "	AGAINST
when they say men look at women like a piece of meat what do they even mean, they want to cook & eat her? #YesAllWomen 	FAVOR
How much radical feminist does there have to be before feminist start rethinking their position about feminism? 	AGAINST
Thanks to the work of people like @everydaysexism they are not only helping women but helping the whole of society 	FAVOR
If you wanna stay home and raise a family, that's cool. But that's your choice and nobody else's. 	FAVOR
@suicidaljac3 eat a pus or somethin lozer 	NONE
Women are superior to men in every aspect #feminist 	FAVOR
@BruiseAurora i'm advocating men to stop loving women. Just have sex with them . #everydaysexism 	AGAINST
I NEED FEMINISM BECAUSE- A man in a room full of women is ecstatic. A woman in a room full of men is terrified. 	FAVOR
Why is Paul Elam not one of the most hated men alive right now!? #feminist 	FAVOR
Yes women it's not fair that men staying at home is shamed by society. We must change ppl additudes  #everydaysexism 	FAVOR
Watching #missrepresentation .. We must change our world. #womenrule #change #beauty 	FAVOR
I won't complain about equal rep of girls in gaming. Princess Peach & Zelda are kick-ass women. Samus is a beast. Hello! #gaming 	FAVOR
Umrao Jaan Ada- a story of not just a life or prostitute but of poise and poesy.  #WOMANPOWER 	FAVOR
Lol what's so ugly about wanting to be equal? 	FAVOR
You want to hear something really ugly, 1 in 5 women will be sexually assaulted in their time in college #MisogynyIsUgly 	FAVOR
WTF LITEraL FUCK AM I EVAN SSEING THIS THING ABOUT. 	NONE
Radios r filled with feminist and rape propaganda. Feminism is alive n well in Malaysia. Their rape guilt tactics won't silence me 	AGAINST
No. Feminists are not ugly. The fact that there isn't equal rights for both men and women is. #FeministsAreBeautiful 	FAVOR
so i guess the new definition of ugly is believing in equal rights... LET ME BE UGLY THEN 	FAVOR
Strict gender roles in the context of a true marriage devoted to raising children will always be the ideal. No substitutes. #tcot 	AGAINST
If feminists are ugly then what are the people calling them ugly must be vile 	FAVOR
"Im sorry if you going to be with me and call me ""you women"" like im a cadigory ill probably but boot out the door "	FAVOR
.@Awyee707 I respect your truck-suck. Why do you not respect girls' innate or chosen doll-love? 	FAVOR
@dancerlwt Have you considered changing your Twitter handle to vagina monologue? 	AGAINST
.@feminismvibes Men don't admit to being raped as readily as women do. So your question is feminist bullshit. 	AGAINST
@AnandDaranand am not stopping your FOE on ur own TL,if u notice;was encouraging u to post topics I'm interested in on my TL #VAW 	NONE
Courting patriarchal approval condemns your sisters to abuse about their physical appearance #patriarchyisugly 	FAVOR
@SkyNews  @EamonnHolmes @SkyJacquie guy from 'beach body ready' advert being interviewed.Conclusion=arrogant male chauvinist idiot 	FAVOR
Contempo Qiwaamah:longer paid maternity leave,flexi working hours,on-site childcare,breastfeeding/breastpumping rooms,equal pay 	FAVOR
The only reason, I stopped at each entrance in #walkingstreet is to have a #LawOfAttraction #viewpoint #dailydevotional 	NONE
@rimmedlarry Actually, the tag was made by feminists so they can narcissistically post selfies to prove they're not ugly. 	AGAINST
"@_sarcasmspasm @MT8_9 Then there's the added level of irony: Their chosen figureheads: Not really ""body positive"" amirite? "	AGAINST
Your physical appearance doesn't define your worth.People should be heard whether theyre conventionally attractive or not. 	FAVOR
All the feminist block me because I speak true. 	AGAINST
@MsLuuna women don't need to shave. 	FAVOR
Wives who dislike cooking mk husbands diet, saying they'll stay fit Actually they want to avoid cooking ;) MCP #WomensProgress2015 	FAVOR
#Feminists can now prove Wage Gap... yet no lawsuits have come forward of women paid less... maybe it doesn't exist.  	AGAINST
Wonder what it'd be like to wear a dress and NOT be sexually harassed for it.  #YesAllWomen 	FAVOR
Lehi high school is my favorite school due to @cltnroberts ps yo gleaves hit me up  #MondayMotivation #WhatAreYouAfraidOf 	NONE
hey @JCDFitness stop teiggering me with ur man gap on the bus i will fight the patriarchy until ur in jail. ty #Equality2015 	FAVOR
What is wrong with you people. Women with self respect should be coveted. Or have we been listening to too much Rush? 	FAVOR
Hey first-world country white women bitching about gender inequality, you're going to be fine #killallmen 	AGAINST
Hey, all you #prolife-ers, if Socrates was born mortal, and his mother thus doomed him to die, is she a murderer? 	NONE
RT @WeNeedFeminism: I don't want to choose between having a family or having a career 	FAVOR
@evelynlns @jes_chastain Agree 100 %! She radiates beauty from the inside out. Such a role model for all  	FAVOR
Women are strong, women are smart, women are bold. #FeministsAreBeautifulisalovemovement 	FAVOR
Want revenge for being a slut?  Cry rape.  Then lie to the world and carry a mattress with you.  #rape #UglyFeminist 	AGAINST
people actually brag about how dank their shatter wax shit is on instagram pls kill me #lol #dabs #wax #420 	NONE
@KrewellaJahan feminism does not equal woman's rights. Feminism is about vaulting one gender over another, NOT equality. 	AGAINST
feminist: *says something about women to be treated as equal human beings*  some asshole: you're ugly  wow nice okay lmao  	AGAINST
@foreigncorrespo I'm never bored. Ppl who easily get bored - like you profess to be - are generally boring. It's a weak wimp-out. 	NONE
@foreigncorrespo And just because you can quote Simone doesn't mean you understand her. Modern femmie-nism is just whining. 	AGAINST
The length of time I take in the bath directly relates to what's happening on Twitter #MondayMotivation  #Worlds2015 	NONE
the fact that people think women need to be appealing and attractive to be heard/seen as equal is why we need feminism 	FAVOR
They want equality but what they're doing is overpowering men. #feminazi 	AGAINST
Saying #AllLivesMatter instead of #BlackLivesMatter is like saying equal rights for all instead of 	NONE
.@cooImemegirl Feminists reject (or ignore the fight for) equality when it might hurt women. That's not equality, duh. 	AGAINST
.@cooImemegirl Damn that wage gap! Sneaky men work longer hours in dangerous jobs and get paid for it! 	AGAINST
.@cooImemegirl Feminists believe mothers should have a say over the father's body, his job, and his money. 	AGAINST
you know what's ugly? can't going out with a short skirt without being judged 	FAVOR
".@johnny_nimble @__heyheather @cooImemegirl ""Equality"": a term used by feminists to poorly hide supremacist agendas. "	AGAINST
@Piddy_X @Nero @CYBERSTALIN It's an attempt at a @GodfreyElfwick parody. #ProteinWorld #BaltimoreRiots #socialism 	NONE
Women in Hollywood are still getting paid less. It is 2015. 	FAVOR
@mit5_anders To paraphrase Friedan, the more a drive is deprived of data, the more its data will expand to fill the space. #1960s 	NONE
I've removed the term #feminist from by bio because racist, transphobic, white feminists have fucked it up for everyone. 	AGAINST
Now Harry is arguing with Dead Girl's father about whose job it is to kill the RapeMurdering villain. #Horns 	NONE
@sammikluber I'm just stating the facts 	NONE
How can you be female and not be a feminist? Like do you not care about your rights as a women or what? 	FAVOR
I wonder what would happen if riots started breaking out across the globe because of how poorly women are treated by some men. 	FAVOR
.@cooImemegirl @TC_Stompa Women don't understand men's plight and so shouldn't force men into fatherhood w/o consent. 	AGAINST
.@cooImemegirl @TC_Stompa So what? It is a man's choice whether he wants to breast feed his children. 	NONE
.@TheActualSarah The UK is considering abolishing prisons for women completely because crime is a man's fault. 	AGAINST
@Vivvyyy what's so wrong with getting dick? How come when guys do it they're praised for it? YOU SEXIST 	FAVOR
You don't have to be anti-men to be pro-women. ~ #SheQuotes #Quote #women #men 	FAVOR
@JahMMARastafari @Vosnic you're incredibly bigoted. From rape to homosexuality.  #mensrights 	AGAINST
Full of #narcissism and self-loathing, a lot of women out there like that. Its got sod all to do with #WrightStuff #WolfWhistling 	AGAINST
@Demias20  Misogynist Patriarchy rapist neckbeard Harasser evil mansplain manspread woman hater born a rapist Etc Etc Etc 	FAVOR
.@brigadam @KlaraJoelsson Abortion is NOT suffering to women - why do you think it is? Do you hate abortion, feminist? 	AGAINST
.@brigadam @KlaraJoelsson The child could be seized for adoption to prolife couples or raised by mom alone - no $$. 	NONE
".@brigadam @KlaraJoelsson You just made the best case against feminist ""equality"" ever! Fuck feminism! "	AGAINST
to the people (male and female- the females always upset me more) who told me I couldn't achieve or do what a boy/man can. 	FAVOR
wanted to pursue a career rather than settle down and start a family in my 20's. Even now, people still tell me time is ticking & 	FAVOR
This always infuriates me. If I was male would I be asked these questions? would I be stereotyped as a 'bitch', 'cold hearted' or 	FAVOR
I don't understand how the concept of a male being a feminist doesn't get in some peoples heads. Equality? Anyone? #feminist 	FAVOR
@Mike_Charmander @MsLatina a right doesn't have to come from a law. They're called equal rights not equal laws 	FAVOR
Today we watch the United States Supreme Court. 	NONE
@spectator exactly women are so weak and incapable the sight of one in a slim skin is giving them an attack of the vapours 	AGAINST
"Men that want ""credit"" from women for being feminists are not feminists at all.  They're just men wanting more privileges #vaw #p2 "	FAVOR
@oakleyftgaga you should be nice to me anyways #NicerInternet 	NONE
they opened a blenders in the vhs GIRLS bathroom today! #TheMoreYouKnow 	NONE
When real life gets controversial, scroll social media faster. #BaltimoreRiots #NepalEarthquake #kyliejennerchallenge 	NONE
People who call themselves beautiful are really the ugliest. #deep #edgy #Philosophy #BaltimoreRiots #Baltimore 	NONE
For Us, By Us: These Apps Are What Happens When Girls #HackForGirlsRights via @autostraddle #girlsintechht.../buff.ly/1HHhM18 	FAVOR
Hey guyz I'm talking about Baltimore *social issues* super smart super current events 	NONE
Walking through my neighborhood i saw 5 different fathers taking care of the toddler with no woman nearby  #househusband 	FAVOR
"Eating a bagel by myself rocking out to ""Man! I Feel Like a Woman!"" #ponytail #freedom "	FAVOR
"Well maybe if more men learned to take ""no"" as an answer, women wouldn't have to say as much #fnm231 "	FAVOR
"@__florencesmith Not ""if"" - women do have equal rights & feminists have made women more equal than men. Go read ""Animal Farm "	AGAINST
Excited to hear author @LeoraTanenbaum  Slut-Shaming in the Age ofthe Internet #slutshaming 	FAVOR
It doesnt take a miracle all takes signature and a few kind people to know not to kill innocent a women #MaryJaneLives 	FAVOR
I take it personally when people call my dog a he. Toni is a girls name too 	FAVOR
I nailed another black feminist. I banged her so hard that she shit. My wife ended up cleaning up the shit too. #BaltimoreRiots 	AGAINST
RT @PatsyMaureen: Females turn into man hating feminists because no man fancy's they're dyke lesbian ass's. 	AGAINST
@ENews Tell @TerrenceJ to stop speaking about women is such a belittling manner. You should NEVER lie to women. #Equality #asshole 	FAVOR
Whether you label yourself a feminist or not I think it's important that we address equal rights.-Taylor Swift. 	FAVOR
#WeNeedFeminism because #NoMeansNo it doesnt mean yes, it doesnt mean try harder!  #YesAllWomen @yesallwomen #RT 	FAVOR
V! Can't wait to see you! # 	NONE
@victoriacoren has an article on women and politics in this months @ELLEUK - it's a must read. #generalelection #politics #women 	FAVOR
What a wonderful interview with @blakelively in @StylistMagazine. Very refreshing feminist views 	FAVOR
@Daily_Feminism -- give us a follow back.   #feminist 	FAVOR
Contrary to stereotype I see feminists all over social media championing causes that benefit men. #YesAllWomen #HeForShe 	FAVOR
@UKIP Also a policy on removing feminists. In their entirety. Thanks for your help with this #VoteUKIP 	AGAINST
"M: FEMINISTS NEED TO GROWA SENSE OF HUMOR W: Okay. (sips from ""Male Tears"" mug) M: AAIGH!  MISANDREEEEEEEEEEE  #YesAllWomen "	AGAINST
those who resist against feminism before us 2016 election, should not be killed. they should be raped to death ... #USElections 	FAVOR
Feminism is not just about women; it's about letting all people lead fuller lives ~ @JaneFonda #life 	FAVOR
Pope Francis: Christians should support equal pay for equal work #popefrancis #worldnews #society #women 	FAVOR
@whenindoubtdo the trigger levels are over 9000 	NONE
@andybud_o The Mito Eve model does not explicit prove 1 ancestor, it narrows down similarities to a matter of a degree... 	NONE
Kristen Stewart: 'Hollywood is disgustingly sexist' #kristenstewart #cloudsofsilsmaria #culture #women 	FAVOR
Male rape is one of the most under-reported crimes; male rape survivors are among the most under-served crime victims. 	NONE
The statistics show that male victims of rape are more likely to be straight than gay. 	NONE
This #MaritalRape law if misused dont give any scope to men to prove their innocence.Even honest men can be trapped & slaughtered. 	AGAINST
Upload sexually provocative pics up for all to see. But if someone you aren't attracted to looks it's harassment? Right 	AGAINST
"One time I said girls don't like being called sluts to a guy and he said ""you can't speak for everyone "	FAVOR
All men accused of rape should be immediately castrated, no questions asked. #RapeCulture #HeForShe 	FAVOR
DEAR FEMINISTS  Why don't you expel the man-haters poisoning your feminism?  Why  you admire them?   #GamerGate #NotY... 	AGAINST
@brandileighhhhh its called sexual coercion, and it is the same as rape. #RapeCulture 	FAVOR
I am not free while any woman is unfree, even when her shackles are very different from my own Audre Lorde #feminist 	FAVOR
This just in: Pop culture still hates women. 	FAVOR
Because young girls are told not to be raped instead of telling boys not to rape 	FAVOR
Because the United States is one of the only countries that doesn't give paid maternity leave 	FAVOR
"Because women are seen as ""soft,"" ""weak,"" and ""emotional"" in the eyes of male politicians "	FAVOR
Because all human beings are created equally by nature. 	FAVOR
@UN_Women @WomenUndrSiege @OSCE_RFoM It should be considered a hate crime if someone makes a threat against a woman. 	FAVOR
Women who falsely accuse men of rape DO NOT care about exploting the suffering of real rape victims.  #GamerGate 	AGAINST
"If the Olympics were 100% feminist, the men's division would be erradicated for ""equality""  #GamerGate "	AGAINST
Woman: you see me as a sex object! Me: you see me as an atm. 	AGAINST
DateOffCampus: Now part of the regular lineup  #SpankAFeminist #feminazi #MRA #Fak... 	AGAINST
Kwink884 thewtfmagazine gamers are fatophobes. ever notice there are no morbidly obese characters in video games? #GamerGate #Not... 	NONE
"Petition for journalists to stop using ""man up"" when they mean ""demonstrate resilience and mental toughness "	FAVOR
It's frustrating & awful that the only voices getting access to a wider audience are the voices of hate. #ConfederateFlag #race 	NONE
@jordanelliott_ Slut is a word made to degrade women, we shouldn't degrade anyone - it's their body's they can do what they like 	FAVOR
I like how rape is one of the most under reported crimes, but the unreported incidents are usually females raping males. But hey. 	AGAINST
"I'll gladly accept my face on ""the least used of the most used bills"" #NeverSatisfied "	NONE
i wish people would understand that true feminists want equality for everyone (even men) not just girls . 	FAVOR
It's not a pleasant world, where if you disagree with feminists, you have to fear for your life and freedoms 	AGAINST
stop with the male animators we want female animators  	FAVOR
#feminists gave women the right to vote. #feministsareliars Nevermind 2/3 of men that voted to give them that right. 	AGAINST
RT VivienneDenue: Code to hack and evil to destroy. Time to get back to work and kick some ass. #gamedev #femaleprotagonist #cybe... 	FAVOR
Done with crime shows making rape about the father instead of the victim 	FAVOR
and when men can only empathize if they picture their daughter going through the same thing. 	FAVOR
@MrRepzion This lady on yt is right, Radical feminist have the loudest voices while normal,logical feminist are being outspoken. 	FAVOR
@equalforwomen why r u on twitter get back in the kitchen #feminist #feminazi #powertowomen #Equality 	AGAINST
RT @LZats: Do you know what women should stop wearing after age 30? Nothing. Women can wear whatever they want, no matter how old. 	FAVOR
"DEAR FEMINISTS  The problem with abortion is not "" too many rapes"" it is too much fucking WITHOUT condoms   #GamerGate "	AGAINST
Multiple abortions means Feminists are not using the contraceptives THEY THEMSELVES demanded.  #GamerGate 	AGAINST
Multiple abortions is one of the few mistakes in life where you are not expected to learn.   Welcome to feminism.  	AGAINST
Gender research helps to develop nursing research  theoretical frameworks, concepts and methodology. @genderanded #research 	NONE
With Hillary's lead over Sanders narrowing, how long before Bernie is accused of misogyny?  #tcot 	AGAINST
@THOSEGOODVlBES wtf what about single fathers 	AGAINST
It's not just #Matildas that get paid less than their male counterparts... It's all women's sports- and in fact all women 	FAVOR
"Anti-#gamergate people who say GG is about ""Zoe Quinn"" are defending domestic abuse.   #NotYourShield #WomenAgainstFeminis... "	AGAINST
I'm glad I was able to raise my kids n a time when my educated mothering decisions for my family were not vilified. #nonvaxxerhere 	AGAINST
The problem with liberals' tolerance is that it is only extended to those who agree with them #tcot 	NONE
Feminists spread misandry. Always try two  create gender conflicts.   #FeminismIsCruelty #dontmancriminate 	AGAINST
Recenter your world. Be the captain of your ship. The author of your life story. 	NONE
Keep the fight going for justice in all our communities #LGBTRights #BlackLivesMatter #JusticeForMuslims #HispanicGirlsUnited 	NONE
@Ricky_Vaughn99  Why is it called HIStory and not HERstory ?!   	FAVOR
It's funny how the #government wants to fix the #gay problems but what about the straight people problems 	NONE
Mother and I were laughed at by first graders because mother threw a bug on me and we both screamed and ran away #strongwomen 	NONE
".@GloriaSteinem said, ""Women are not going to be equal outside the home until men are equal in it."" Do you agree? #antifeminism "	AGAINST
@camerongreen22 Young man, stop wearing your sister's clothes and makeup. You look ridiculous. #SpankAFeminist 	AGAINST
now let's raise the pay for females and make it equal to what men get payed #EAQUALITY 	FAVOR
@CB_Printer @adamnick_nick @victorymonk feminists want special right not equal right. Don't b a feminist #feministcruelty 	AGAINST
@CurlyChloe_ psst, it can't get anymore equal so....now it is a joke!  #SpankAFeminist  #dontmancriminate  #feminist 	AGAINST
@OccupyCourt Family Court is not a court. It is INQUISITION. #FEMINAZIS 	AGAINST
@MeninistTweet why do white women pretend to ne black, lies aboit dad & family instead going to the mental hospital? 	NONE
After a gr8 day for US equality, I think of the girls who pose with @DanBilzerian; setting female equality back 40yr #gaymarriage 	FAVOR
@arristotlee Thank you, #progressive-minded pursuers of familial and societal Dystopia. #Democrats #Liberals 	NONE
im a strong independent black woman who don't need no daddy #lol #girlpower 	FAVOR
I think if Australia had a female PM n female majority MPs #MarriageEquaility would be legal here now #auspol 	FAVOR
WOW.  Why is gay marriage legal but LESBIAN marriage isn't?!  WHAT THE FUCK @POTUS FIX THIS NOW 	NONE
@70kha @scroll_in We can't pass judgements and offer advice on issues like hijab as if they belong to subaltern cultures.  	NONE
Ruth_Blane: _AnAvgJoe_: RT Ruth_Blane: Ruth_Blane: Ruth_Blane: Ruth_Blane: ReverseDowry: RT manojmane: Take this !! #Feminazi #sc... 	AGAINST
_AnAvgJoe_: RT Ruth_Blane: BansalSatnam: RT Ruth_Blane: ReverseDowry: RT Ruth_Blane: manojmane: Take this !! #Feminazi #scrap498a... 	AGAINST
Even if I didn't love @taylorswift13's music, I'd still be a fan. She's a brilliant young woman. 	NONE
The single biggest stimulus the economy can have is equal pay. - Gloria Steinem #alaac15 	FAVOR
Pop quiz: Whats the greatest fear of the oppressor? #humanrights #BlackLivesMatter 	NONE
@DFoxtrot15 @FeminismIsLies so labeling womne? OMG SEXISM! labeling men? well, most men are like that, so... 	AGAINST
Men want women to take their name in marriage for male pride. Because female pride doesn't matter. #genderequality 	FAVOR
I think it's okay for a woman to take a mans name if she wants to. #genderequality 	FAVOR
"If we have equality women wouldn't be expected to submit to the ""traditions"" of marriage. #genderequality "	FAVOR
"Watch colors code red now. It shows how a newly wedded wife con's the family. ,""con bride"" #colors #scrap498a "	NONE
@sass_unicorn lol! Young male children for 	NONE
One gay one straight. one male One female. One friendship. #Equality #Friends 	NONE
What a great accomplishment #marriageequality , too bad it still sucks to be black or a woman in America. #racism #truthbomb 	FAVOR
@fdGhtP54 @_Lemaign @kungfuman316 as I said, most friends I made of sex appeal to me, but I do what I must, FOR 	NONE
The cutting and mutilation of my and my daughters' genitals is an expression of my 	FAVOR
RT VivienneDenue: bittergourd TheMarySue thank you! My game is going to knock your socks off! #femaleprotagonist #gamersunite #in... 	FAVOR
son, you can't slut shame a female for having nudes and jerk off to the same nudes at night. you ain't right. #smh 	FAVOR
I hate feminism, give me a reason why I shouldn't. #feminist #notallmen #HeForShe 	AGAINST
I do not wish for #Women to have power over #Men but over themselves. #Milan #KnockKnock #PAK_Army #PTIFamily 	FAVOR
DEAR FEMINIST SUPPORTERS People like you with your endless concessions to feminists just prevent their accountability. 	AGAINST
DEAR FEMINISTS  The evidence of your closeted hate is your refusal to address man-hate in feminism.   #GamerGate 	AGAINST
Feminism is a fashionable form of narcissism because personal trauma & personal retribution is what drives feminists. 	AGAINST
The responsibilities Feminism admits are as ornamental as the intelligence of the average feminist. #OnlyRights 	AGAINST
CEOs apologizing to feminists pressure only awards Feminism with its sought-after intellectual immunity. #GamerGate 	AGAINST
You are not penetrating our vaginas, we,  WE ARE ENGULFING YOUR PENISES!  #insideamyschumer 	FAVOR
Old, insecure females forcing hatred of men on a younger generation of women 	AGAINST
@E__Strobel @rsmccain @instapundit @CHSommers @CathyYoung63 @AsheSchow @mensrightsrdt @Anneeliz1 That's right. All sex is rape. 	NONE
@FaZeNikan @dznCosta why is men in front of women, you misogynistic pig 	FAVOR
Just watched Mad Max: Fury Road.  Amazing! Everything! And as a woman watching this film... Amazed. #MadMaxFuryRoad 	NONE
And no femaskanks, your gender studies degree isn't as valuable as a S.T.E.M degree.... 	AGAINST
@CosmopolitanUK why does someone not create a female festival celebrating women?! Surely it's a no brainer! #art #music #history 	FAVOR
i have autocorrect switched off smh i dnt need u im independent 	NONE
RT gamergatenews: RT CaptHaddock83: Ha Ha hilarious! #Feminists desending on #SpankAFeminist like mad harpies, #SJWs #game... 	AGAINST
@marieclaire Or...She's a grown 21st century woman who may do whatever pleases her! Especially with her fashion and body!  	FAVOR
What do feminists want: All humans, male and female, should have equal political, economic and social rights. Equality. 	FAVOR
Women are not going to be equal outside the home until men are equal in it-- Gloria Steinem  #women #men 	FAVOR
Of course ugly feminists hate sexy porn stars, rhinos hate the fact they they will never be a unicorn.  #GamerGate 	AGAINST
@FCKH8 is the poster child for why identity politics suck. 	NONE
DEAR ANTI-PORN FEMINISTS   If you've never eaten popcorn while watching porn you are missing out in life... #GamerGate 	AGAINST
"History is ""his story;"" we need ""her story"" too! "	FAVOR
To men who make contact with women thinking they are owed a response #patriarchy 	FAVOR
Shhhh! @Bayonethics can't you see @monikarmoore is bragging? Even feminists have the right to be bitches... #GamerGate 	FAVOR
Someone should do a #Meminist Frequency video response highlighting the violence against men portrayed in video games. 	AGAINST
Funny how it's not misogyny or objectification when feminists completely erase female agency to make an argument. @IroynA 	AGAINST
Dear 80 percent of women: you don't think like us hence you are scum. - Love, @Jezebel #GamerGate 	AGAINST
RT EmilAaslund: Dear third wave feminists: I hate you, not women. Get your definitions straight. #GamerGate #slipperyslope #NotYo... 	AGAINST
"Goldstein is the #SanFrancisco City Archivist, she asks ""Where are the women in the history of our city?"" #alaac15 #archives "	FAVOR
Staying well informed on sexual violence in the news is important yet often leaves me ranting at screen. #rapeculture 	FAVOR
"I have seen feminists disagree by saying ""shut up."" Aside from simple manners, this treatment of others is befuddling. ~ @lizfurl. "	AGAINST
Feminist outrage over American girls being recruited by ISIS? Zero. 	AGAINST
"@it_is_cancer @fat_tush categorizing homelessness as a ""job"". "	NONE
#SignsYoureInTheUSA You are attacked by feminists who labels you the patriarchy for cooking sunny side up eggs  	AGAINST
feminists be like: don' judge a book by its cover! unless the cover is a straight white male. 	AGAINST
How can I be a more feminist doctor? What issues do we get wrong as doctors? #HeForShe #Feminist 	FAVOR
when you get sexually harassed twice  	FAVOR
"*watching house of cards with my dad* ""I could be First Lady."" ""Why not president?"" ""YEAH DAD! Next woman president right here!""  "	FAVOR
Women are shamed if they don't want children, but then told if they want to be payed equally they shouldn't have children at all. 	FAVOR
@Noin007 though I'm not a girl so maybe I'm not  qualified to comment on women's issues, according to 	AGAINST
@Not_Jaewon_Kang lol Jaewon you are so good in the hood! We just like poetry over pressing issues 	NONE
Selective listening a #character trait of convenience #feminists 	AGAINST
#narcissism another character trait of most #feminist convenience 	AGAINST
Pushing misinformation about #wagegap is the new anti vaccination. 	AGAINST
Australia even has a fucking Minister for women for fucks sake!IsAwful 	AGAINST
Here we are fighting for equality when @Wimbledon decide to only allow ladies heat breaks. Do men not get hot too? 	AGAINST
"#SharkRocket ""Real People, Real Results"" commercial only includes women - So, men don't vacuum? #NotBuyingIt "	AGAINST
@BizerBizer @GiftofGodsFavor It's a sexist, misandrist whine-fest drenched in victimhood. 	AGAINST
What the fuck do women even do? I mean seriously they're just useless other than sex.  #womensrights #Feminist 	AGAINST
Ignoring peer-reviewed research and empirical evidence is such a feminist thing to do. #GamerGate #NotYourShield 	AGAINST
if your feminism is sex worker exclusive or trans exclusive I want no part in it. #intersectionality 	AGAINST
Cat Pt. 2: Today I found my cat is a feminist. #cat #feminist #kindofanokstory #life 	AGAINST
What about how in the world of weed, the male plants are mostly deemed useless as they only produce seeds & don't flower 	AGAINST
@virtuadad @TakedownMRAs the library, quit attempting 2 hurt others just so they'll think the way u do 	AGAINST
"I'm honestly surprised that feminist extremists like @lenadunham aren't screaming ""sexist!!"" at gay men. "	AGAINST
@Martin_chris4 Car women will as well. 	AGAINST
I am #NotAFeminist b/c human rights are for all humans, not just half of them.   #antifeminism #antifeminist 	AGAINST
Some feminist's would shut down the entire global porn industry & put millions on benefits/welfare & not even care 	AGAINST
"A quote from mother about being a woman: ""We really got it shit didn't we?"" Aye. Bring on fourth wave feminism! #4thwavefeminism "	AGAINST
men suck. women suck. everybody sucks 	AGAINST
For all y'all who only pay attention to men's sports, something fairly important is happening now with USA women's soccer 	AGAINST
usa is only good at futbol if women are playing 	AGAINST
So you want equality in the work place between men and woman but you won't take the trash out..? Makes sense 	AGAINST
RT @rapebombing: #HowToSpotAFeminist like @infinitehoran_ They block you & then stalk you for days/weeks afterwards. 	AGAINST
Why should woman stick together?  I don't like half of you cunts. 	AGAINST
Getting haircut b/c I have a job interview. Because being male and having shoulder length hair is 'unprofessional' 	AGAINST
@LaNaria_Athalia Are you using women as sex objects to sell your sexist hate movement, yes you are. 	AGAINST
@HeyItsAlexM @Keatmyshiz hes lyin to u maam, u can see thru this transparent asshat. just call him a moron u no u wanna do it 	AGAINST
And people wonder why #feminists aren't taken seriously...  At least give me 1 every time I hear this, I'd be rich!  	AGAINST
Anita #Sarkeesian - living the damsel in distress trope. 	AGAINST
@deanesmay The Command-and-control mentality runs deep with #feminists. The Swedish Feminist Initiative is open with it 	AGAINST
@abbystew292 @gogreen18 If you buy into this brainwashing I hope you never get selected for jury duty involving a sex crime 	AGAINST
When there's a strong female lead and you get so so excited cause there's no gratuitous sexual violence 	AGAINST
Modern marriage is like a modern car, shinny, disposable and not made to last.   #GamerGate 	AGAINST
@TheSun @George_Osborne Innocent men should NOT be convicted of domestic violence! #SayNoToFeminism 	AGAINST
In reading the #BeingFemale tweets I realized how fortunate I am to be able to rent and live in an apartment alone. #rights #fight 	AGAINST
@AsheMareexoxo literally you are so on point about the male gaze and BS about fake nerd girls 	AGAINST
#Weneedfeminism because Twitter has its very own misogynist harassment machine. #YesAllWomen #HeForShe #Feminist 	AGAINST
U.S. putting a women on $10 bill instead of $20... anyone else think it's a BS compromise? #TheNew10 #WomenOn20s #Feminist 	AGAINST
#Pretty.#Young #Thing. Catchy MJ song/ perfect summary of discourses surrounding professional #female #disempowerment. #gender 	AGAINST
@PennyRed oh the irony of a radfem accusing others of low self-esteem. #GamerGate 	AGAINST
There is one more basic cause [of the abuse of women], and that is that, in general, men don't give a damn. (Jimmy Carter) 	AGAINST
If the sexes had equal intellectual abilities the collective inferiority complex of feminism would not be necessary. 	AGAINST
RT @MandaReneK: Feminism: the belief that men and women should have equal rights and opportunities. #feminist #lovetheladies #sor... 	AGAINST
Their other complaints are just fake shit they made up, this on the other hand is amazingly controlling and entitled 2/ 	AGAINST
Watch out, the feminists' next move will probably be demanding pay for the First Lady. 	AGAINST
Writing and wondering why ovarian and seminal aren't BOTH synonyms for original? #OppressedByThesaurus #OvariesBeforBrovaries 	AGAINST
"The representation goal of Feminism has gone from  ""Invent more female characters""  to  ""Replace all male characters "	AGAINST
I'm blocked by 4 of the most frequent posters on #YesAllWomen. 2 of which I've never even debated with. Can't handle facts  	AGAINST
All mascots in women's world Semi-final are girls?... #Equalityforall 	AGAINST
Feminists are about equality between men and women as much as segregationists were about equality between blacks and whites 	AGAINST
...OR SLOW DOWN YOUR CALL TO YELL AT ME WHILE I WAIT FOR THE BUS!!! #WHATTHEACTUALFUCK 	AGAINST
"Most non-feminist ppl are ""category-fluid"". #Feminists, you'd best respect that!  #antifeminism #misogyny #MGTOW #MRA #antiSJW "	AGAINST
MyVagina kicked the Shit out of HisCock / 	AGAINST
@marieclaire Pretty sure most of us are A-okay without having her on our team. And it's aaaalll about #choice, anyway. #feminists 	AGAINST
Men can no longer look at women's boobs, tattoos, or even look them in the eyes.  Soon: mandatory castration for all males. 	AGAINST
*sigh* One small step back for women, one giant leap forward for lonely perverts. #ChrissyTeigen 	AGAINST
"Being raised by a feminist in rotting, soiled clothes - ""I'm not your slave! "	AGAINST
#INeedMeninist because as a blk man white women make more than all minorities despite the lies of feminist. 	AGAINST
"As a child, had to 'recycle' own socks from festering laundry heap, as feminist mother says ""I'm not your slave! "	AGAINST
A year of relentless harassment of folks talking about rape & abuse on #YesAllWomen = thriving rape culture on social media 	AGAINST
Interesting in the video she kidnaps and tortures(tying up, confinement, etc) the wife or GF of the evil accountant 	AGAINST
Really interesting debate about whether men can also be feminists #BSCConf15 #criminology 	AGAINST
Seriously can't believe they gave the women heat breaks and not the men #Wimbledon 	AGAINST
Can't find it in me to be friends with people who throw around the word 'slut' or judge women for being sexual beings. #Equality 	AGAINST
Seriously can't believe there are so many Hilary supporters right now.  	AGAINST
"NiceFeminists are passive onlookers to man-hate. Their excuse?  ""It's not up to me to prevent hate in my movement!""  "	AGAINST
"All the people who support abortion, to bad their parents didn't practice that ""right""  #YesAllWomen #UniteBlue "	AGAINST
#HowToSpotAFeminist?-> 3 Feminists believe in rape culture instead of their erotomania + delusions of persecution.   	AGAINST
#HowToSpotAFeminist?->  7 Feminists compare themselves to successful men & non feminist women to harbor jealousy.  	AGAINST
#HowToSpotAFeminist?->  10 Feminists struggle to control their lives and try to micromanage other women's lives.  	AGAINST
#HowToBeUnhappyLikeAFeminist?  Feminists fill their conversations with gossip & HATE AKA #killallmen.  #GamerGate 	AGAINST
feminist response people wearing meninist clothes-  mock them or call them derogatory names? NOT A HATE GROUP ??? 	AGAINST
@prpodcastshow I hope there is a women's size for the #GameofKings championship belt. Or is that just for men? 	AGAINST
"Amusing how feminists swap their own personal ""I don't like it"" by ""Women don't like it"".   #GamerGate #NotYourShield "	AGAINST
Women in STEM is imaginary motivation with low conversion numbers. A waste of money on natural quitters.  #GamerGate  	AGAINST
"When did trivializing the suffering of authentic rape victims become a ""sport""?  Welcome to feminism.   #GamerGate "	AGAINST
"The mentality of #GamerGate is,   ""HEY! OUR Feminists are suuuuper stable! BTW don't agitate them with any criticism""  "	AGAINST
If women do it, it cannot be immoral or evil. Right?  Welcome to feminism defending pedophilia promoter #LenaDunham  	AGAINST
DEAR FEMINISTS IN GAMING  Respect is earned with hard work, not playing the victim.  #GamerGate 	AGAINST
"IF FEMINISTS WERE HONEST  ""Be careful, if you use logic in this conversation I will somehow drag it into rape""  "	AGAINST
When did people without taste buds decide to ban tasty food?  Welcome to Sex-Negative Feminism   #GamerGate 	AGAINST
"IF FEMINISTS WERE HONEST ""Be careful, don't say 3rd world women suffer more or I will say you are a rapist"" #GamerGate "	AGAINST
@kbambi1376 It's not a conscious choice that's made. Betas make women feel unsafe, unprotected, right? #SpankAFeminist 	AGAINST
@elllode BUT SHE RUNS IN HIGH HEELS 	AGAINST
People think because I'm a feminist I hate men. No I'm a feminist, I believe in equality for all. #EqualityForAll 	FAVOR
Misogynist abuser @NickRinke whining that feminists are blocking him. Let's make his day and all bock him. #YesAllWomen 	FAVOR
Abusive Misogynist  @NickRinke whining that feminists are blocking him. Let's make his day and all bock him. #YesAllWomen 	FAVOR
my coworker called me gay because i didn't stare at these girls who came in, SORRY but i respect women and this is why i need 	FAVOR
I am really proud to be a @HeforShe and I want to thank @EmWatson for being such a powerful feminist #HeForShe 	FAVOR
Grr! That subject is not allowed to be joked about! - Typical Feminist, regarding every topic of humor #SpankAFeminist 	AGAINST
What!? Women take pictures of themselves naked or in sexy lingerie & text them? Fucking Patriarchy! #TweetLikeAFeminist #SJWLogic 	AGAINST
Feminism on twitter is the black hole of human intelligence, just like creationism.  #GamerGate 	AGAINST
TASK 1.Present a feminist the fact most infanticides are perpetrated by the mother.  2.She will blame it on a male(s). 	AGAINST
"IF FEMINISTS WERE HONEST   ""I want a worldwide matriarchal dictatorship with all men enslaved to women""   #GamerGate "	AGAINST
"@abbeysaurusrex_ C) the hell was that video? D) the guy spelled ""break"" wrong. E) if Megalodon is alive maybe it's a she Brewer "	NONE
"DEAR LYING FEMINIST JOURNALISTS  If candy crush saga is ""hard core gaming"" then masturbation is marriage.  #GamerGate "	AGAINST
@patelology @jameelajamil please RT for our gender equality project! 	FAVOR
Anti feminism - because being a good person isn't for everybody. 	AGAINST
With or without this farmer's tan, I bang bare bitches #MisogynistColloquialisms #DontSayBitch 	NONE
Patriarchy Theory - designed to project the prejudice and insecurity of feminists onto men 	AGAINST
"#LikeAFeminist I think any woman who doesn't identify as a feminist has ""internalised misogyny "	FAVOR
'Half victims, half accomplices, like everyone else' Simone De Beavoir 	NONE
@jaclynf, @JessicaValenti, @AmandaMarcotte and @PennyRed are why feminists don't live on the same planet as us. 	AGAINST
@chelss_21x love how it doesn't distract female teachers 	NONE
Why is it bad for the Garrick Club to be men only but not bad for my gym to have a women only room? #Hypocrites 	AGAINST
if women didn't have double standards then they would have no standards. #MagicMikeXXL #YesAllWomen 	AGAINST
The majority of anti-abortion leaders are men and none of them will ever be pregnant.  #genderequity 	AGAINST
A vote by a woman is a wasted vote @femfreq @feministculture 	AGAINST
"@POBREClTA @JustLove_Katie @WillBrianna ""running your dick sucker"" yes because THAT is the purpose of your mouth lol "	AGAINST
Ashamed of my fellow man. Making pigs of ourselves at every given opportunity.  #feminist #ashamed 	AGAINST
@ZaraLovesScript A bloke we both know, @BigGoodJohn, asked me to offer congrats for being clever; still seems stunned girls ARE. 	AGAINST
Hey fellow Feminists, we need to fight back against this ridiculous war-glorifying that celebrates #men.  #Triggered #Transpatriot 	AGAINST
Heterosexual male's sexual orientation is not a social/capitalist construct that it can be changed with a blink of an eye.  	AGAINST
"the Left 10 years ago ""Keep government out of our bedrooms"" Today: ""you must verbally consent to every step"" ""no drunk sex "	AGAINST
Spanish Civil War publishing cookbooks & author gender points to women's lack of access to education, ind wealth #osfc15 	AGAINST
Rethink your beach clothes. Bc it may oppress some people!! #thisoppresseswomen 	AGAINST
If masculinity is toxic, then I must be a nuclear waste facility. #gamergate #dumbfeminist 	AGAINST
#WageEquality means Individuals with Equal Responsibilities, Training, Proficiency deserve Equal pay. #WomenRights 	AGAINST
Do you know the difference between Activism and Advocacy? #SDG #youthdevelopment 	AGAINST
Girls over 130 shouldn't wear a swim suit #womenintech 	AGAINST
It's hard being a woman, constantly annoyed by things that don't really matter on the grand scheme of things. Wish I was a man 	AGAINST
