@TheView I think our country is ready for a female pres, it can't ever be Hillary 	AGAINST
Hillary can not win. Here's hoping the Dems offer a real candidate like Warren. #Warren2016 	AGAINST
#StopHillary2016 @HillaryClinton if there was a woman with integrity and honesty I would vote for such as woman president, NO 	AGAINST
Use your brain, keep Hillary out of the White House.Clinton2016 	AGAINST
@HillaryClinton Hillary pandering with her logo. #ClintonFoundationscandal #ClintonCash 	AGAINST
Where's the campaign store is the real question? I am ready to buy some Hillary gear 	FAVOR
It's a miracle, suddenly #Democrats don't mind having someone who voted for war. 	AGAINST
Hillary doesn't want to put anyone in prison anymore. Obviously worried about her own future. 	AGAINST
@HillaryClinton bad wife, bad role model for women, bad lawyer, bad First Lady, bad Senator, horrible Secretary of State. 	AGAINST
Everything Hillary touches ends up being a scam, a lie, a cover-up, or a failure. William L. Just who we want as president. 	AGAINST
#Hillary to stop for #pizza today to garner the #Italian vote. #MSM is worthless. #libertynothillary #HillNo 	AGAINST
@WSJ . Clinton Foundation to keep accepting bribes from foreign governments #WhyImNotVotingForHillary 	AGAINST
Sorry, Hillary's new normal folk image doesn't take away from Behgnazi & her 0 foreign policy successes as Secretary of State. 	AGAINST
CEO pay the target for 2016 election. From someone who makes more than most CEO's but you drank the Kool-Aid. 	NONE
@NBCNews including repealing the first amendment. Way to go 	AGAINST
RT @AnthonyCumia: If Hillary IS elected, I have my transition team together to smoothly move me from a racist to a sexist. 	AGAINST
@Chris_1791 @newsbusters 2 years ago #Hillary never answered whether she used private email #Liberal media passed on reporting 	AGAINST
@dnewhauser take that, Marco Rubio. @GOP cannot pander to the Latino vote while pushing policies that hurt the community most. 	NONE
Bill Clinton just wants to be the first dude to be President and bang one. 	NONE
crazy to think next up for the Oval Office is either going to be Hillary or a Republican 	AGAINST
@CheekyGent @ChuckCJohnson Hey Hillary is on her to way to buy votes too! #HillarySoOld 	AGAINST
"RT @NicolaSturgeon: ""It's official: Hillary's running for president,"" says her campaign chief. Excellent! "	FAVOR
"Only in a SEXIST AS FUK world would we question the ""qualifications"" of a former SECRETARY OF STATE. "	FAVOR
Forgive #CherylRios of her stupid comments about women being president. She will blame it on that time of the month anyways. 	NONE
@seanhannity we lost 4,000 of our Military boys when your President pulled out of Iraq.  #LiberalConsequences  	AGAINST
Does Hillary really need to run this country? Could we just make her president of the Bingo club at Shady Pines?  #tcot #p2 	AGAINST
@HillaryClinton is at the top, and has spent her whole career growing government, keeping the deck stacked. #LibertyNotHillary 	AGAINST
Problem with #libertarian is it's not even a decreed party. A house devided against itself, will not stand. think this news to 	NONE
Hillary Clinton for Ambassador to ISIS. 	AGAINST
So when all you brave patriots stop Hillary, who you going to replace her with, Jeb Bush? LOL. #losers 	FAVOR
Wondering what the NEXT idiotic GOP smear against @HillaryClinton will be. It's coming for sure. Just don't know details yet. 	FAVOR
Hillary is killing it so far on the trail. She's finally showing her personal side and I think it will benefit her profoundly. 	FAVOR
@HillaryClinton had more twitter followers then all four major Republican candidates (Bush, Rubio, Paul, Cruz) COMBINED. 	FAVOR
#HillaryClinton has yet to release @ClintonFdn donors... Public deserves disclosure. #Scandals #lies #Clintons 	AGAINST
RT @hale_razor:#HillaryAccomplishments 1 of select few people fired 4 being 2 unethical 2 investigate Watergate 	AGAINST
Marriage equality a constitutional right! Woot #HRC2016 #hillaryclinton #readyforhillary #vote #hillaryfor2016 ##mpotus 	FAVOR
Hillary needs to go to a Sheetz gas station after 10 pm to see the real America. 	AGAINST
Hillary's campaign events are scripted dog & pony shows designed to shelter her from vetting b4 the coronation 	AGAINST
Why is Hillary lying AGAIN about something news worthy? What's news worthy is if she doesn't lie about something 	AGAINST
I love the smell of Hillary in the morning. It smells like Republican Victory. #TedCruz2016 #MarcoRubio 	AGAINST
I'd still rather have Aaron Hernandez as President than Hillary.  	AGAINST
I would LMAO if some negro Democrat decides to run for President. #HillaryClinton2016 #HillarysBigAnnouncement #HillarysDonors 	AGAINST
@senna1 @KirillWasHere how many men are getting their dicks sucked daily in congress, etc and no one gives a shit... 	NONE
@HillaryClinton Stop raising taxes and let people keep more of their wages! #LibertyNotHillary #StandWithRand 	AGAINST
"3. Fixing America's political system by getting rid of ""unaccountable"" money, and 4. Protecting the country. "	NONE
@KoriWasinger @JButtawipo she also voted for the Iraq war and was responsible for gathering @TheDemocrats votes to support it. 	AGAINST
If Hillary will lock Americans in classrooms during her campaign, she'll have no problems locking us all up whenever she wants. 	AGAINST
@AlyssSmithh There she is pant suite Hillary to hide those thighs #HillarysDonors #HillarysBigAnnouncement #Benghazi #Obama 	AGAINST
@HillaryClinton will pick @SenWarren for VP -Mark my tweet. #UnstoppableTicket #ElizabethWarren 	FAVOR
@46drhouse - Be interesting to see how Hillary defends same when questioned.  She will eventually have to answer questions. 	AGAINST
@tjhansen @owillis serious, if trump runs you'll get a trump tattoo? Calling the Donald!! 	NONE
Breaking News: #Hillary trades campaign bus for a broomstick. 	AGAINST
"I'd love for some reporter to ask, ""Sec Clinton, will u b returning the White House china, if elected? Or did u already hock it? "	AGAINST
.@CaptYonah @thehill Fine; unethical or illegal quid pro quo uranium deal works for me. 	NONE
@ConservatveGurl those of us that also have a brain will be voting against Hillary... 	AGAINST
@FoxNews #HappeningNow optics problem? No the real Hillary Clinton has stood up #ClintonCash #IaVotes 	AGAINST
"Also the $400,000 ""speaking fees"" #Hillary took from Goldman Sachs for two ""speeches."" @Joan_Vennochi "	AGAINST
Before leaving my dad's I took the liberty in framing and put up the pictures he has meeting Hillary and Bill Clinton in '92 	FAVOR
RT .@ChuckNellis  .@HillaryClinton name change; it's no longer HRC it's now Hillary Uranium #Benghazi Clinton. Take note. 	AGAINST
@HillaryClinton I notice that you didn't condemn the lawless actions of the rioters. 	AGAINST
Obama:  climate change or bush?  Who to blame...?  Hillary:  right wing conspiracy in Baltimore. #BalitmoreRiots 	AGAINST
Students of #BaylorUniversity are y'all ready for #MarcoRubio in #2016 #BU #Baylor #Bears #BaylorBears #NewAmericanCentury #GOP 	AGAINST
"The only thing that I would pay money for is to hear Hillary Clinton say ""I QUIT and I'm GUILTY"" that would be worth millions. "	AGAINST
Hillary Clinton keeps sending me emails, and when I try to unsubscribe, I get an error message. THIS IS CANCER 	AGAINST
Join the Twitter movement! RT or fav for a mention or follow back! 	NONE
#BernieSanders is running for president, don't the #democrats already have one really old guy running?? 	AGAINST
297 days until I can register to vote!!1 year 193 days until Election Day #RockTheVote #democrats #everyvotecounts 	FAVOR
Hillary will get past the primaries cause Dem voters don't think she can do any wrong. But she will be beat in November 	AGAINST
@HillaryClinton Did your rich Saudi donors, who execute gays, join the team? #Hypocrite #WakeUpAmerica  	AGAINST
I think I am going to vote for Monica Lewinsky's Ex- boyfriends Wife 	FAVOR
And the working american tax payer keeps on paying for the unethical liberals who want to destroy this great country of ours. 	AGAINST
Hillary Clinton vs. Bernie Sanders primary will be like the brawl over applesauce at the retirement home. #ReadyForHillary 	FAVOR
Too many women in too many countries speak the same language Í¢\91\84\91\EE of silence. HILLARY CLINTON #HillaryCliton #Hillary4Women 	FAVOR
Too many women in too many countries speak the same language  of silence. HILLARY CLINTON #HillaryCliton #Hillary4Women 	FAVOR
@TheDemocrats @DNCWomen I'm down to help for 2016 election. 	FAVOR
@Norsu2 secret Clinton docs? gee WHAT a surprise! 	AGAINST
Too far @realDonaldTrump. That's just too fucking far. #BaltimoreUprising #Obama 	NONE
Hillary Clinton makes Nixon look like an amateur schoolboy #ClintonCash #ClintonFoundation #Clinton 	AGAINST
@thehill #MamaHillary is making the case here & just exclusively how to deal with complex social issues. #cnn #bbc #Mamaclinton 	FAVOR
@_Poli_Ana_ No, she's got the #BlackLivesMatter vote w/o even talking to them.  Most blacks are brainwashed by @TheDemocrats 	AGAINST
A proper introduction of Hillary Clinton should begin with five words: Will the defendant please rise #WhyImNotVotingForHillary 	AGAINST
Don't get it twisted. A major presidential candidate using her first policy speech to talk about mass incarcertaion. 	AGAINST
Saw a bit of @HillaryClinton 's speech & I was proud to hear her plans for policy improvements in our justice system. Thanks! 	FAVOR
@Upworthy @HillaryClinton It should be illegal for an employer to discriminate against their workers. #EqualityForAll 	FAVOR
A body-cam on every cop, private servers for Cabinet Secretaries. 	NONE
@JohnKerry @BALWANIKAPIL @HillaryClinton @StateDept @tomperriello  I didn't realize #PayToPlayDiplomacy was such a big hit!  	AGAINST
RT @FutureTXLeader: Who in #CorpusChristi is ready for #MarcoRubio in #2016 #Hooks #CC #Texas #TX #361 #KeepTexasRed #GOP #Tea... 	AGAINST
I've been doing my reading and I do have to to say, I'm wildly impressed by Hillary Clinton 	FAVOR
@BarackObama thanks for selling out all the workers who voted for you for pushing FastTrack #sellout 	NONE
@thehill all the more reason to vote #Democrat in 2016. #ACAworks #GetMoneyOut #RestoreTheVRA #Bernie2016 #waronpoverty 	FAVOR
I'm still so happy my voter ID came in the mail  	NONE
#HillaryClinton is hiring #Monsanto lawyers to help her become President. The next president shouldn't be aided by Monsanto 	AGAINST
It's good that after 30 years in public service (with zero accomplishments), Hillary is finally ready 2 serve the public! Lolol 	AGAINST
RT @spanglishpop: Thanks @GOP keep sending in the clowns! It makes this upcoming election very entertaining #latinos2016 #Rock... 	NONE
Laughing at the Republican Party. The BEST they can offer is #DonaldTrump and #JebBush?   #HillaryClinton has got this! 	FAVOR
In high school, decided to be the first woman president in 2016, but I never got into politics & don't have Trump's money. 	NONE
@GOP Obamacare stays and the Confederate flag goes. You guys have had quite the shitty week, haven't you? 	NONE
Come visit me at the Jefferson County Fair! Representative Curt Hanson will tell a joke and I'll tell a story about why vote 	NONE
Federal gov't social spending 61% of budget. Federal gov't defense spending 22% of budget. Something is definitely wrong here. 	NONE
@HillaryClinton Awesome video!  Vote for Chelsea's mom. 	FAVOR
#CarlyFiorina on #hannity, very impressive. A serious presidential candidate vs. A bad actress. 	AGAINST
@FoxNews report shows U.S. State Department cannot locate 15 of Hillary Clinton's Private Emails.  Not so fast, Hillary! 	AGAINST
@Callisto1947 @texasman2008 @AmyMek Hillary's new Campaign Slogan:  HILLARY - NOTHING TO HIDE EXCEPT THE TRUTH !!!  #TCOT #CCOT 	AGAINST
Donald Trump is a joke. His a simpleminded idiot, and I have nothing else to say about him. He can go FUCK him self. 	NONE
"#HillaryDebateQuestion So you profess admiration for #MargaretSanger who wanted to rid the country of ""negros"". Explain please? "	AGAINST
Y did #randpaul take donations from a #WhiteSupremacy group after shaking hands with black leaders? #BlackLivesMatter #gop 	NONE
@petefrt this is how GOP needs to be handling campaign not attacking each other but showing all hillary fails. #uniteright 	AGAINST
My vote is definitely for Hillary. I don't want Bush's dumb ass. Don't want Trump either.  #HillaryClinton 	FAVOR
@tedcruz won't be there. I'm supporting @HillaryClinton for President. #lgbtrights #ACAWorks 	FAVOR
My sexy daddy Obama had two wins this week. Happy for him & democrats   	NONE
#Obama is riding high!! #ObamaCare #LoveWins #Republicans tearing out their hair, whatever is left of it ..Next is #SCOTUS 	NONE
A Black President,Healthcare 4 all, Marriage Equality...what's next?..a Woman President?!Damn RIGHT! #SCOTUS #MarriageEquality 	FAVOR
RT @muradguderian: Democrats are Red, Obama is a Communist, I'm a true Patriot, So stop Hillary.  #tcot 	AGAINST
SCOTUS dealt a blow to Hillary Clintons last campaign 'promise'... What is she running on now? Corruption, lies, and deceit. 	AGAINST
Do America a favor, If you feel you must vote for a woman candidate, Vote for #Carly2016 who at least has integrity unlike 	AGAINST
@gerfingerpoken2 he made a careless mistake, she deliberately broke many laws & still lies about it. 	AGAINST
@PolitiBunny @Seja75 @hubbit @HillaryClinton I'm voting in the Democrat primary this year...to support @BernieSanders.  	AGAINST
#WonderWoman movie, #TheMuppets TV show, #StarWarsVII, #MarriageEquaility #Obama. I guess I can leave social media now. Oh wait 	NONE
@thegirlwithfood though. But there are people saying they just aren't going to vote at all which is ridiculous so 	NONE
@tedcruz @IamTheWindowMan  GET OUT OF MY STATE YOU BUM! #UniteBlue  	NONE
Let's make Secretary Clinton, President Clinton - @AGMarkHerring @vademocrats 	FAVOR
@kimkennedy4 thats why they still have no voting rights. 	NONE
You're a idiot if you vote for Hillary, her and Obama are The Epitome  of what's wrong with this country #Benghazi 	AGAINST
You cant fix stupid, might not be able to vote them out either. 	NONE
If I get killed. Thank @realDonaldTrump . I was tweeting mad crap about him.  I don't take it back. 	NONE
@realDonaldTrump WHY IS IT THAT YOUR CLOTHING LINE IS MADE IN CHINA? Can U say Lier pants on fire? #morningjoe #unitedblue 	NONE
SLOWLY SLOWLY THE DEBT CRISIS WILL IMPLODE NATIONS CURRENCY #AmericaDeadBrokeSAVE THE DOLLAR NOW 	NONE
My dad told me he's voting for Hillary. I'm so proud. LOL 	FAVOR
@HillaryClinton I'd ask #HillaryClinton to stop lying about #Benghazi & #ClintonFoundation ties to #terrorist #muslim #ISIS. 	AGAINST
@HillaryClinton You Flip/Flopped on the Gay marriage issue; must be more votes available with your current view? 	AGAINST
@LaureneDiCillo @NBCNews @dl34l And why are major media outlets not exposing Hillary's blatant flip flopping on this issue. 	AGAINST
96 commit cards collected for Hillary in Greenville, SC so far! #FellowsSC 	FAVOR
Save an intern.... Keep Bill & Hillary out of the White House.  	AGAINST
@philadper2014 @LouiseKatina Hillary's New Campaign slogan is:  HILLARY - NOTHING TO HIDE BUT THE TRUTH!  #tcot #WakeUpAmerica 	AGAINST
Madam President Clinton; you have all the gays vote. #jarrid 	FAVOR
Gay marriage is a minor setback for Fox News. Tune in for a full collapse on November 8, 2016. Lots of tears and broken hearts. 	NONE
@HillaryClinton So what's your goal for setting up victims for #BillClinton to assault? #HillaryClinton #ChelseasMom #tlot 	AGAINST
@LindaSuhler and the sheeple will still vote for her 	AGAINST
One of Hillary Clinton's biggest idols is Margaret Sanger, who called for the extermination of colored people. 	AGAINST
@HillaryClinton Will #pervert #BillClinton be there if winner is teen girl? #HillaryClinton #Democrats #liberals #tlot #GOP 	AGAINST
When you fav supports the wrong candidate  (@ladygaga)  #Bernie2016 	NONE
I hate Hillary Clinton and Obama, please go die together  thrown into the ocean get ripped into prices by sharks. 	AGAINST
The only Intelligent Choice for USA is Hillary Clinton....You can not afford to stay HOME ...you must VOTE and VOTE #UniteBlue 	FAVOR
I got it! I got it!   A Hillary accomplishment!   She's managed to stay out of prison despite a 30-year crime spree. #tcot #ocra 	AGAINST
@Reince Facts confirm what we knew. Used server to prevent e-mails from becoming public records. Like Obama, no transparency. 	AGAINST
Republican candidates continuing to spread hatred and alienating the voters. Hillary wins!  #LoveWins #MikeHuckabee #Rubio2016 	FAVOR
Hillary Clinton might end up having my vote. She's been tackling so many issues that America needs to face. 	FAVOR
Apple and Walmart = MADE IN CHINA Why does our country continue to sell us out to China in every way possible? #AppleMusic  	NONE
if Hillary wins the election there's a chance we might move to Australia. #HILLARY4PRES 	AGAINST
@moser_kristen  I love how you pay more attention to the democratic candidate than you own republican candidates #KnowTheEnemy 	NONE
& I bet that @HillaryClinton is thee best choice for President in 2016she's the next best one for the people  #Vote 	FAVOR
@realDonaldTrump @WhoopiGoldberg @Univision #VoteForHillary @HillaryClinton isn't racist. A leader who demands #EqualityForAll 	FAVOR
Bernie or Hillary? Prefer Bernie but Hillary fine. Either way, Dems gotta stand together in 2016. #FeeltheBern 	FAVOR
"Night, sleep tight, don't let Hillary bite. says @Tony_Tickets   ""Nightmares"" is all I say.  "	AGAINST
"Never vote for @RickSantorum ""for the survival of our country"" #LoveWins "	NONE
@voxdotcom   #wgn #WGNTV - now mentions ROMNEY? #Hillary CARE = ROMNEY CARE = #Obamacare -- now PUBLIC OPTION for ALL 	NONE
I guarantee Hillary could care less about black rights.  If Obama did, blacks wouldn't be in the same predicament still.  	AGAINST
Hillary LIES, yet people still desire her as the President of the United States. #sad 	AGAINST
@17leete17 hahaha. He is some kind of special..  this is why Hillary's going to win! Hahaha. 	FAVOR
Will the media ever get real with Hillary? #2016 #Benghazi #Clinton 	AGAINST
#Putin, the last thing the US needs right now is another #Clinton or #Bush in the White house. We're a dynasty now? #Jeb2016 	AGAINST
Hillary's New Campaign slogan is:  HILLARY - NOTHING TO HIDE BUT THE TRUTH!  #tcot #WakeUpAmerica 	AGAINST
@GOP Of course @HillaryClinton is silent. That insures she doesn't have 2 stand 4 ANYTHING & less chance of offending voters 	AGAINST
Don't you someday want to see a well qualified candidate by the president of the United States? #ReflectingHillary 	FAVOR
Our Queen City is currently infested w/ out-of-state plate Priuses driven by millennials w/ Hillary bumper stickers. #MHT 	AGAINST
"#DemocRAT2014Slogans: ""Why work? When you can VOTE DemocRAT - twice!"" #tcot "	AGAINST
I think it's funny people think Bernie can take on Hillary and Bill 	FAVOR
As much as @BernieSanders's poll numbers have jumped I still have Hillary winning the Dem. nomination. 	FAVOR
@marcorubio will not let our enemies take advantage of us like Obama is doing & Hillary will do! @TeamMarco #NewAmericanCentury 	AGAINST
Just think how many emails Hillary Clinton can delete with today's #leapsecond 	AGAINST
The kind of Gov that Liberals promise you can only be achieved and sustained with a Conservative Government.   #HeatWave #tcot 	AGAINST
"So glad @ChrisChristie has announced his candidacy - fits right in with all the other ""qualifies"" republicans on the list. "	AGAINST
"Hillary claims to be a ""champion"" of the middle class, but @RandPaul tax plan cuts the FICA tax, benefiting the middle class. "	AGAINST
It is offensive when the mexican flag flies on US soil. California state capital. #Lovewins #univision #foxnews #DonaldTrump 	AGAINST
@LeahR77 @DrMartyFox > With continued #Obama's & @TheDemocrats Admin policymaking, #USA will become #Greece! #WakeUpAmerica #NJ 	AGAINST
@asphaultangel13 Afterall, they're just a poor black family trying to pay the bills!  @crousselle #WhyImNotVotingForHillary #TCOT 	AGAINST
Fashion News: Hillary has a new clothing line coming out called Flip Flops R US   #tcot #Benghazi 	AGAINST
@GovChristie can't even run NJ and wants to be president? I'd vote for him before @HillaryClinton 	AGAINST
Republican donors have numerous candidates to put their money on. Dems basically have one. We're gonna get killed financially. 	AGAINST
Chris Christie for President? HAHAHAHAHA!  I don't think so!  @HillaryClinton #Clinton #Hilary 	AGAINST
@HlLLARY @ToniforAsm Hillary for Prez = Obama's third term and that's the last thing we need!! 	AGAINST
@FoxNews @GovChristie @HillaryClinton Actually she should be disqualified from running!How many scams and ethics problems now? 	AGAINST
@HillaryIn2016 hey I just checked your blog. Kudos! Keep it up! 	AGAINST
White, middle-aged men did a pretty good job leading this Country for 230 yrs. Racist? Sexist? No, I'm a realist. 	AGAINST
Hillary can't use a fucking fax machine but you idiots are going to vote for her to be President?  	AGAINST
@gerfingerpoken2 #hillary is most likely a felon many times over but has been protected by the political class. 	AGAINST
#Hillary's still very weak among grassroots - as shown by how strong #BernieSanders got how fast on how little. @AaronBlakeWP 	AGAINST
Now that #Hillary is raising money like an incumbent president, can we stop pretending that she won't be the nominee? 	AGAINST
All Americans have value to our society, it's called a vote. #LiberalLogic    #InternationalJokeDay 	AGAINST
Hillary's campaign raised $45 million  91% of all donations were $100 or less  This is a record. Beating Obama's record in '11 	AGAINST
Win with the Blacks. Put some of your focus on the racial tension between Blacks and Whites. 	AGAINST
@WashTimes @BretBaier Why is there no outrage about all the smoke & mirrors w/ this candidate? Are you hiding Hill! #SpillHill 	AGAINST
@docdebags @awelab1956 @BuzzFeedAndrew @BuzzFeedNews  It will. Otherwise we're guaranteed GOP in control of all 3 branches. 	AGAINST
.@FoxNews @brithume ok.. So where are these emails coming from? Didnt @HillaryClinton already say the server was erased? #LIES 	AGAINST
I dreamt about Hilary Clinton last night. Does this mean her plans to control us and take over the world are coming true? 	AGAINST
#Obama administration lies again.. Knew of #HillaryEmails being private.. transparency???? 	AGAINST
@HillaryClinton will be the nominee for the Democratic Party. Period. And she's gonna win the Presidency too. #SorryBernie 	AGAINST
#AskPOTUS Would you fire the #GOP congress for not doing their job if you could? #GOPFail 	AGAINST
Take it easy Ed, #BernieSanders is a side show. Democrats are having some fun before getting back to reality in Nov 2016.  	AGAINST
The Kool-Aid drinking leftanistas continue to close ranks with support for Madame Secretary. WTF? Hillary is a fraud full of lies. 	AGAINST
@HillaryClinton is opening 10 more offices in Iowa this week.  She's not playing around! #iacaucus 	AGAINST
Obama give Americans OVERTIME Pay! Republicans give Americans Welfare Checks! #tcot #UniteBlue 	AGAINST
#Univision ignores Latino candidate Marco Rubio because he doesn't fit their narrative.They're invested with Hillary #rubio2016 	AGAINST
"Overheard at the Davenport open house: ""Oh, I know you from Facebook!"" #DigitalOrganizing "	AGAINST
@AutumnNAlston @JonathanDKF @_sarah_babb_ @McCollumMike @HillaryClinton @HillaryforSC Inaugural tweet from our new account! Go 	AGAINST
@hughhewitt like I tweeted you way back when, #ACA software can be fixed , but GOP strategic mistake of 'repeal' can't be fixed 	AGAINST
@msnbc @Lawrence @JoeBiden @SenSanders  we love Joe and Bernie--but they ARE too OLD--they would end up a #OneTerm President 	AGAINST
@RobBently @JonahNRO @BernieSanders Hillary campaign  will shortly announce that Sanders was born in Canada. Yeah that's it. 	AGAINST
@politico   YAWNzzzzzzzzzzzzzz could keep the z's going for the full amt of Tweet characters but you get the point. 	AGAINST
The Democrats are not creating Al QAEDA, they are creating A NUCLEAR ISIS.  THINK ABOUT THAT.  	AGAINST
You know emailgate must be going nowhere when Fox News are hashing out the Bosnia 'sniper fire' story again. 	AGAINST
It's what's best for business and presidential seat for #HillaryClinton  	AGAINST
The biggest dumps of bad info is b4 a holiday weekend. What comes out of WH and state dept today? #HillaryEmails  #LiarLiar 	AGAINST
@CBSThisMorning Bernie Sanders had record crowds in Madison wis why no mention from you guys you talked about trump #Trump 	NONE
Pundits say Jim Webb facing uphill battle with Hillary.  Really, it's with Bernie for the anti-Hillary vote.  #JimWebb 	AGAINST
Exciting to hear more about our Fellows all across the country on tonight's call. Special shout-out to the #FellowsIA. 	NONE
@AnitaFinlay @politico Hillary's doing the right thing -- staying focus on her campaign. 	FAVOR
@gerfingerpoken Why is this woman like teflon?  She has committed enuf egregious crimes she should B superglued 2the dang wall! 	AGAINST
If you support @HillaryClinton you are supporting another term of the policies of George W Bush. #democrats #mepolitics 	AGAINST
The most revealing part about Hillary's released emails is that they're pretty much as boring as mine. #nofriends 	AGAINST
@RAM0018 @joanwalsh @Salon @BreeNewsome @chrislhayes Without the blacks and minority voters? NO, Won't happen! 	NONE
@popcornreel @joanwalsh @SenSanders @BernieSanders He is what he is and it doesn't resonate with minority and black voters! 	NONE
#Putin, #NothingMoreAmericanThan voting for a politician to lead the country when she can't even handle email. #think 	AGAINST
2 people that are surprising? Trump &Fiorina. Why? Cause they're being honest w/what they think.  Obama built that.  	NONE
Didn't think about that. Don't think I'd ever vote for someone with dual citizenship. Can't believe it's legal. #Bernie 	NONE
Clinton entitlement is the proverbial American hemorrhoid #tcot #Opinionated 	AGAINST
Norman Hsu illegally donated $850,000 to @HillaryClinton, there is evidence he worked for China.  White House for sale.  	AGAINST
@kryptickaos_ I would have to agree, but I would be surprised if he gets the nom. Jeb bush has the money, and he's a moderate. 	NONE
@HillaryClinton lied about the cost of the gala, she was fined for it, but if it were @GOP they'd be in jail  Unfit for office  	AGAINST
@ZekeJMiller @BretBaier @danmericaCNN  How could anyone vote for that woman?  	AGAINST
@RedHatGeek Hillary's nose from lying is now bigger than Bill's cigars. 	AGAINST
Hopefully Hillary Clinton gets cancer and dies before she gets the opportunity to embarrass our country any further. #july4th 	AGAINST
@JOEL5H @wonderfullone @Bipartisanism I hear the Peter Gunn theme. She's going to kick some serious GOP ass. 	AGAINST
At least the few mistakes made by @GOP candidates on the campaign aren't felonies like the ones@HillaryClinton makes.#OhHillNo 	AGAINST
@anthonyweiner super out of touch and stupid.   Please go away. #NYCPride #NYC 	AGAINST
@greta What #Bernie2016 has done is work for DECADES on behalf of the American people not the corporatocracy who own corrupted 	AGAINST
Do we breathe & live or ignore & collectively succumb to toxins of political, ecological, unwanton oligards? #p2 #bernie2016 	AGAINST
YAAAS, Hillary! @TsarRhys wins best dressed here at the #Merrimack 4th of July parade! #HillaryforNH 	AGAINST
.@HillaryClinton The spatula seems appropriate, given that it can be used to easily flip positions if the heat gets to high. 	AGAINST
"Why does the "" shit barometer "" always rise when Republicans speak? #USA #July4 "	AGAINST
Since #SNL ain't that funny anymore please @JoeBiden run for president.. if even just for the hilarious debates between you & 	AGAINST
I support Bernie on account USA needs a new direction but, if he loses in primary ,I'll support Hillary Clinton. #Sanders2016 	AGAINST
@HillaryClinton Your treatment of the press, Amb Stevens' fam, and the intel of the American ppl is enough to send you to jail 	AGAINST
@NumbersMuncher @HillaryClinton She's the animal!! She's also a sellout!!! Ppl that vote for her are sellouts!! #NoHillary2016 	AGAINST
/#Leftest #Hippocratic #Domecrats won't vote for #FineLady #MichellBachmann but will vote for #EmailScandal #Benghazi #Killary 	AGAINST
Support #independent #BernieSanders because he's not a liar. #POTUS #libcrib #democrats #tlot #republicans #WakeUpAmerica 	AGAINST
@Babbsgirl2 @DrMartyFox She is as bad or worse possibly than #Obama and she will continue to break laws as if she is invincible. 	AGAINST
@akawhit1 ITS TIME TO ROPE OFF KILLARY @FoxNews DELETE HER OFF YOUR BALLOT SHE IS A CLONE OF SODOM  INSANE OBAMMAD #WakeUpAmerica 	AGAINST
